0字节	0位元組
0杆	0桿
1字节	1位元組
1杆	1桿
2字节	2位元組
2杆	2桿
3字节	3位元組
3杆	3桿
4字节	4位元組
4杆	4桿
5字节	5位元組
5杆	5桿
6字节	6位元組
6杆	6桿
7字节	7位元組
7杆	7桿
8字节	8位元組
8杆	8桿
9字节	9位元組
9杆	9桿
甲型肝炎	A型肝炎
甲肝	A肝
乙型肝炎	B型肝炎
乙肝	B肝
丙型肝炎	C型肝炎
丙肝	C肝
IP地址	IP位址
乔戈里峰	K2
·威尔士	·威爾士
·威爾士	·威爾士
一杆	一桿
七杆	七桿
三杆	三桿
三极管	三極體
三極管	三極體
达累斯萨拉姆	三蘭港
上落客	上下客
上樑	上梁
下樑	下梁
落車	下車
卑詩省	不列顛哥倫比亞省
不來梅	不萊梅
不来梅	不萊梅
幺	么
以太网	乙太網
九杆	九桿
了結他	了結他
二手烟	二手菸
二手煙	二手菸
二杆	二桿
二极管	二極體
二極管	二極體
交互设计	互動設計
五杆	五桿
阿塞拜疆	亞塞拜然
阿斯旺	亞斯文
亚里士多德	亞里斯多德
亞里士多德	亞里斯多德
人工智能	人工智慧
人机交互	人機互動
行人路	人行道
石勒苏益格	什勒斯維希
石勒蘇益格	什勒斯維希
伊利诺伊州	伊利諾州
伊斯坦布尔	伊斯坦堡
伊斯坦布爾	伊斯坦堡
伊斯兰堡	伊斯蘭瑪巴德
伊斯蘭堡	伊斯蘭瑪巴德
埃博拉	伊波拉
伊丽莎白	伊莉莎白
伊利沙伯二世	伊莉莎白二世
俯卧撑	伏地挺身
掌上壓	伏地挺身
伯明翰	伯明罕
服务器	伺服器
佛罗伦萨	佛羅倫斯
操作系统	作業系統
系数	係數
避孕套	保險套
傅里叶	傅立葉
光盘	光碟
光驱	光碟機
开普勒	克卜勒
開普勒	克卜勒
克罗地亚	克羅埃西亞
克羅地亞	克羅埃西亞
克里斯托弗	克里斯多福
全角	全形
万维网	全球資訊網
全角度	全角度
全角色	全角色
八杆	八桿
公共交通	公共運輸
六杆	六桿
凯瑟琳	凱薩琳
嘉芙蓮	凱薩琳
划着独木舟	划著獨木舟
划着竹筏	划著竹筏
划着船	划著船
打印	列印
列支敦士登	列支敦斯登
前波美拉尼亚	前波莫瑞
前波美拉尼亞	前波莫瑞
加蓬	加彭
加泰罗尼亚	加泰隆尼亞
加泰羅尼亞	加泰隆尼亞
加沙地带	加薩走廊
加沙地帶	加薩走廊
包豪斯	包浩斯
局域网	區域網
局域网络	區域網路
十杆	十桿
特立尼达和多巴哥	千里達及托巴哥
特立尼達和多巴哥	千里達及托巴哥
南斯拉夫联盟共和国	南斯拉夫聯邦共和國
南斯拉夫聯盟共和國	南斯拉夫聯邦共和國
南希·佩洛西	南西·裴洛西
蘭茜·佩洛西	南西·裴洛西
卡斯特罗	卡斯楚
卡塔尔	卡達
卡塔爾	卡達
铆足	卯足
打印机	印表機
打印機	印表機
厄利垂亚	厄利垂亞
厄立特里亚	厄利垂亞
厄立特里亞	厄利垂亞
厄瓜多	厄瓜多
厄瓜多尔	厄瓜多
厄瓜多爾	厄瓜多
源代码	原始碼
圆珠笔	原子筆
反烟	反菸
反煙	反菸
可卡因	古柯鹼
便携式	可攜式
叱咤	叱吒
叱咤9	叱咤9
叱咤M	叱咤M
叱咤叱	叱咤叱
叱咤咤	叱咤咤
叱咤樂壇	叱咤樂壇
斯坦福大学	史丹福大學
斯皮尔伯格	史匹柏
斯特劳斯	史特勞斯
斯威士兰	史瓦帝尼
斯威士蘭	史瓦帝尼
斯蒂芬	史蒂芬
斯大林	史達林
斯科普里	史高比耶
士碌架	司諾克
斯诺克	司諾克
結他	吉他
乞力馬札羅	吉力馬札羅
乞力马扎罗	吉力馬札羅
吉布堤	吉布地
吉布提	吉布地
基里巴斯	吉里巴斯
图瓦卢	吐瓦魯
圖瓦盧	吐瓦魯
吸烟	吸菸
吸煙	吸菸
吕宋烟	呂宋菸
呂宋煙	呂宋菸
格丁根	哥廷根
哥特式	哥德式
哥斯达黎加	哥斯大黎加
哥斯達黎加	哥斯大黎加
唐纳德·特朗普	唐納·川普
當勞·特朗普	唐納·川普
當奴·特朗普	唐納·川普
卡拉奇	喀拉蚩
乔治·奥威尔	喬治·歐威爾
佐治亚	喬治亞
佐治亞	喬治亞
格魯吉亞	喬治亞
格鲁吉亚	喬治亞
单反相机	單眼相機
單鏡反光機	單眼相機
嘯咤	嘯吒
四杆	四桿
圈樑	圈梁
图卢兹	土魯斯
圖盧茲	土魯斯
圭亚那大区	圭亞那大區
圭亚那省	圭亞那省
戛纳	坎城
堪培拉	坎培拉
坦桑尼亚	坦尚尼亞
坦桑尼亞	坦尚尼亞
端口	埠
首席执行官	執行長
报道	報導
塑料袋	塑膠袋
塞舌尔	塞席爾
塞舌爾	塞席爾
萨拉热窝	塞拉耶佛
薩拉熱窩	塞拉耶佛
塞尔维亚和黑山	塞爾維亞與蒙特內哥羅
塞爾維亞和黑山	塞爾維亞與蒙特內哥羅
塞爾維亞與蒙特內哥羅	塞爾維亞與蒙特內哥羅
塞维利亚	塞維亞
西維爾	塞維亞
塞黑	塞蒙
外泄	外洩
多美和普林西比	多美普林西比
塔希提	大溪地
共和联邦	大英國協
英联邦	大英國協
英聯邦	大英國協
太空飛行員	太空人
宇航员	太空人
穿梭機	太空梭
航天飞机	太空梭
宇航服	太空衣
航天器	太空飛行器
尼日利亚	奈及利亞
尼日利亞	奈及利亞
內羅畢	奈洛比
内罗毕	奈洛比
奥塞梯	奧塞提亞
奧塞梯	奧塞提亞
奥拉夫·朔尔茨	奧拉夫·蕭茲
奧拉夫·朔爾茨	奧拉夫·蕭茲
忌廉	奶油
荷里活	好萊塢
威廉姆斯	威廉士
威斯特法伦	威斯伐倫
威斯特法倫	威斯伐倫
威士顿康星	威斯康辛
威尔士	威爾斯
威爾士	威爾斯
西部数据	威騰電子
存盘	存檔
孟德爾遜	孟德爾頌
门德尔松	孟德爾頌
安哈尔特	安哈特
安哈爾特	安哈特
安提瓜	安地卡
安提瓜和巴布达	安地卡及巴布達
安提瓜和巴布達	安地卡及巴布達
洪都拉斯	宏都拉斯
宣泄	宣洩
宿务	宿霧
密克隆人	密克隆人
密歇根	密西根
老挝人民民主共和国	寮人民民主共和國
老撾人民民主共和國	寮人民民主共和國
老挝保护国	寮保護國
老撾保護國	寮保護國
老挝	寮國
老撾	寮國
老挝语	寮語
老撾語	寮語
波里活	寶萊塢
对着干	對著幹
高峰时段	尖峰時段
高峰时间	尖峰時間
贊比亞	尚比亞
赞比亚	尚比亞
尼克松	尼克森
尼日尔	尼日
尼日爾	尼日
屋樑	屋梁
山樑	山梁
雅马哈	山葉
巴厘	峇里
特朗普	川普
机床	工具機
機床	工具機
珍寶客機	巨無霸客機
巴塞罗那	巴塞隆納
巴塞隆拿	巴塞隆納
巴布亚新几内亚	巴布亞紐幾內亞
巴布亞新幾內亞	巴布亞紐幾內亞
巴士拉	巴斯拉
巴巴多斯	巴貝多
布基納法索	布吉納法索
布基纳法索	布吉納法索
布什	布希
布殊	布希
布拉迪斯拉发	布拉提斯拉瓦
布拉迪斯拉發	布拉提斯拉瓦
勃兰登堡	布蘭登堡
勃蘭登堡	布蘭登堡
布里斯托尔	布里斯托
布隆方丹	布隆泉
希拉克略	希拉克略
希拉莉	希拉蕊
希拉里	希拉蕊
希特拉	希特勒
残疾人奥林匹克	帕拉林匹克
殘疾人奧林匹克	帕拉林匹克
残奥	帕運
殘奧	帕運
巴尔米拉环礁	帕邁拉環礁
帕劳	帛琉
帕勞	帛琉
希拉克	席哈克
账	帳
干着急	干著急
干着	幹著
畿內亞	幾內亞
几内亚比绍	幾內亞比索
幾內亞比紹	幾內亞比索
比利牛斯	庇里牛斯
库尔德人	庫德人
庫爾德人	庫德人
库尔德斯坦	庫德斯坦
庫爾德斯坦	庫德斯坦
庫爾德族	庫德斯坦
库尔德族	庫德族
康涅狄格	康乃狄克
约翰斯顿岛	強斯頓環礁
汇编	彙編
形而上学	形上學
形而上學	形上學
得克萨斯	德克薩斯
得克薩斯	德克薩斯
德累斯頓	德勒斯登
德累斯顿	德勒斯登
德里达	德希達
特拉华	德拉瓦
特拉華	德拉瓦
文翠珊	德蕾莎·梅伊
特蕾莎·梅	德蕾莎·梅伊
快闪存储器	快閃記憶體
闪存	快閃記憶體
恩賈梅納	恩將納
恩贾梅纳	恩將納
情景喜剧	情境喜劇
處境喜劇	情境喜劇
想象	想像
愛德文	愛德溫
艾滋	愛滋
艾奧瓦	愛荷華
爱德华州	愛達荷州
应用程序	應用程式
懸樑	懸梁
懸臂樑	懸臂梁
戈尔巴乔夫	戈巴契夫
戈爾巴喬夫	戈巴契夫
戒烟	戒菸
戒煙	戒菸
戴克里先	戴克里先
打印度	打印度
扛大樑	扛大梁
披头士	披頭四
抽烟	抽菸
抽煙	抽菸
拒烟	拒菸
拒煙	拒菸
挑大樑	挑大梁
卷烟	捲菸
捲煙	捲菸
積架	捷豹
控件	控制項
推杆	推桿
第比利斯	提比里西
挥杆	揮桿
揮杆	揮桿
搜索引擎	搜尋引擎
莫士比港	摩斯比港
莫尔斯比港	摩斯比港
摩根士丹利	摩根史坦利
阿拉伯撒哈拉	撒拉威阿拉伯
台球	撞球
攻打	攻打
数字化	數位化
數碼化	數位化
数字技术	數位技術
數碼技術	數位技術
数字照相机	數位照相機
数码照相机	數位照相機
數碼照相機	數位照相機
数码相机	數位相機
數碼相機	數位相機
数字信号	數位訊號
數碼訊號	數位訊號
数字电视	數位電視
數碼電視	數位電視
数字音乐	數位音樂
數碼音樂	數位音樂
調制解調器	數據機
调制解调器	數據機
斯堪的納維亞	斯堪地那維亞
斯堪的纳维亚	斯堪地那維亞
斯洛文尼亚	斯洛維尼亞
斯洛文尼亞	斯洛維尼亞
新罕布什尔	新罕布夏
施罗德	施洛德
旱烟	旱菸
旱煙	旱菸
太阳微系统	昇陽電腦
太陽電腦	昇陽電腦
比勒陀利	普利托利
普利策	普利茲
普利策奖	普立茲獎
芯片	晶片
智能卡	智慧卡
智能手机	智慧型手機
智能手機	智慧型手機
智能电话	智慧型電話
智能電話	智慧型電話
智能机器人	智慧機器人
智能機械人	智慧機器人
知識產權	智慧財產權
知识产权	智慧財產權
萌島	曼島
马恩岛	曼島
木杆	木桿
木樑	木梁
尾班車	末班車
列奥纳多	李奧納多
杜塞尔多夫	杜塞道夫
杜塞爾多夫	杜塞道夫
迪拜	杜拜
汤加王国	東加王國
湯加王國	東加王國
东盟	東協
亚细安	東協
東盟	東協
东南亚国家联盟	東南亞國家協會
東南亞國家聯盟	東南亞國家協會
柏林墙	柏林圍牆
柏林牆	柏林圍牆
乍得	查德
查韦斯	查維茲
克林頓	柯林頓
克林顿	柯林頓
柱樑	柱梁
戴卓爾	柴契爾
撒切尔	柴契爾
格仔山	格仔山
格仔	格子
格林納丁斯	格瑞那丁
格林纳丁斯	格瑞那丁
格林納達	格瑞那達
格林纳达	格瑞那達
桃金娘	桃金孃
台式电脑	桌上型電腦
乒乓	桌球
乒乓球	桌球
杆弟	桿弟
杆身	桿身
杆头	桿頭
杆頭	桿頭
樑上	梁上
樑柱	梁柱
梅尔·吉布森	梅爾·吉勃遜
梵高	梵谷
棟樑	棟梁
桑巴舞	森巴舞
榴莲	榴槤
榴蓮	榴槤
枪支	槍枝
标准杆	標準桿
標準杆	標準桿
毛里求斯	模里西斯
毛里裘斯	模里西斯
樸茨茅夫	樸茨茅斯
樹樑	樹梁
橋樑	橋梁
機械人	機器人
几率	機率
電單車	機車
橫樑	橫梁
枱	檯
字段	欄位
奥巴马	歐巴馬
奧巴馬	歐巴馬
正在叱咤	正在叱咤
圣佩德罗苏拉	汕埠
文莱	汶萊
沙律	沙拉
沙地阿拉伯	沙烏地阿拉伯
沙特阿拉伯	沙烏地阿拉伯
法属圭亚那	法屬圭亞那
波斯尼亚	波士尼亞
波斯尼亞	波士尼亞
波斯尼亚和黑塞哥维那	波士尼亞與赫塞哥維納
波斯尼亞和黑塞哥維那	波士尼亞與赫塞哥維納
博茨瓦納	波札那
博茨瓦纳	波札那
博索納羅	波索納洛
博索纳罗	波索納洛
波黑	波赫
洋烟	洋菸
洋煙	洋菸
泄劲	洩勁
泄压	洩壓
泄密	洩密
泄底	洩底
泄恨	洩恨
泄愤	洩憤
泄气	洩氣
泄洪	洩洪
泄漏	洩漏
泄露	洩露
泄题	洩題
帕特里克	派屈克
海洛英	海洛因
侯賽因	海珊
侯赛因	海珊
温得和克	溫荷克
溫得和克	溫荷克
鼠标	滑鼠
满杆	滿桿
漏泄	漏洩
汉诺威	漢諾瓦
漢诺威	漢諾瓦
泽连斯基	澤倫斯基
澤連斯基	澤倫斯基
乌冬面	烏龍麵
烤烟	烤菸
烤煙	烤菸
無樑樓蓋	無梁樓蓋
无烟日	無菸日
無煙日	無菸日
无烟环境	無菸環境
無煙環境	無菸環境
烟熏	煙燻
首席运营官	營運長
熏烤	燻烤
熏肉	燻肉
熏黑	燻黑
版权信息	版權資訊
疯牛病	狂牛症
瘋牛症	狂牛症
鐵托	狄托
铁托	狄托
塞拉利昂	獅子山
独联体	獨立國協
獨聯體	獨立國協
独立国家联合体	獨立國家國協
獨立國家聯合體	獨立國家國協
多民族玻利維亞國	玻利維亞多民族國
多民族玻利维亚国	玻利維亞多民族國
波利尼西亚	玻里尼西亞
波利尼西亞	玻里尼西亞
本傑明	班傑明
本杰明	班傑明
球杆	球桿
理查德	理察
卢塞恩	琉森
危地馬拉	瓜地馬拉
危地马拉	瓜地馬拉
巴伦西亚	瓦倫西亞
華倫西亞	瓦倫西亞
冈比亚	甘比亞
岡比亞	甘比亞
肯尼迪	甘迺迪
留尼汪	留尼旺
毕加索	畢卡索
综合征	症候群
徵狀	症狀
发泄	發洩
勃朗宁	白朗寧
百慕大	百慕達
卢旺达	盧安達
盧旺達	盧安達
真人騷	真人秀
睾	睪
知識產權局	知識產權局
知识产权局	知識產權局
知識產權署	知識產權署
知识产权署	知識產權署
石樑	石梁
硅	矽
硅藻	硅藻
硬盘	硬碟
硬件	硬體
盘片	碟片
磁盘	磁碟
磁道	磁軌
禁烟	禁菸
禁煙	禁菸
福尔马林	福馬林
福爾馬林	福馬林
私烟	私菸
私煙	私菸
程序员	程式設計師
编程语言	程式語言
空中客车	空中巴士
空气质量	空氣品質
空氣質素	空氣品質
突尼斯	突尼西亞
绑紧跳	笨豬跳
蹦极跳	笨豬跳
短信	簡訊
約翰內斯堡	約翰尼斯堡
约翰内斯堡	約翰尼斯堡
纽黑文	紐哈芬
新奥尔良	紐奧良
新奧爾良	紐奧良
新西兰	紐西蘭
新西蘭	紐西蘭
紙煙	紙菸
纸烟	紙菸
索尔仁尼琴	索忍尼辛
索贊尼辛	索忍尼辛
所罗门群岛	索羅門群島
所羅門群島	索羅門群島
索馬里	索馬利亞
索马里	索馬利亞
索馬里蘭	索馬利蘭
索马里兰	索馬利蘭
維爾京群島	維京群島
维尔京群岛	維京群島
弗吉尼亚	維吉尼亞
佛得角	維德角
维特根斯坦	維根斯坦
網絡遊戲	網路遊戲
网络游戏	網路遊戲
互联网	網際網路
互联网络	網際網路
互聯網	網際網路
互聯網絡	網際網路
因特网	網際網路
繞樑	繞梁
系着	繫著
卢瓦尔	羅亞爾
盧瓦爾	羅亞爾
卢浮宫	羅浮宮
樂行童軍	羅浮童軍
意大利	義大利
意大利面	義大利麵
意裔	義裔
昂山素姬	翁山蘇姬
昂山素季	翁山蘇姬
圣基茨和尼维斯	聖克里斯多福及尼維斯
聖吉斯納域斯	聖克里斯多福及尼維斯
聖佐治	聖喬治
圣地亚哥	聖地牙哥
圣迭戈	聖地牙哥
厄尔尼诺	聖嬰
厄爾尼諾	聖嬰
圣文森特和格林纳丁斯	聖文森及格瑞那丁
聖文森特和格林納丁斯	聖文森及格瑞那丁
圣赫勒拿	聖赫倫那
圣卢西亚	聖露西亞
聖盧西亞	聖露西亞
圣马力诺	聖馬利諾
聖馬力諾	聖馬利諾
肯尼亚	肯亞
氨基酸	胺基酸
脊樑	脊梁
自由泳	自由式
三藩市	舊金山
艾森豪威尔	艾森豪
埃菲尔	艾菲爾
阿里埃勒·沙龍	艾里爾·夏隆
阿里埃勒·沙龙	艾里爾·夏隆
帕塔亚	芭達亞
黎克特制	芮氏
里氏0	芮氏0
里氏1	芮氏1
里氏2	芮氏2
里氏3	芮氏3
里氏4	芮氏4
里氏5	芮氏5
里氏6	芮氏6
里氏7	芮氏7
里氏8	芮氏8
里氏9	芮氏9
里氏地震规模	芮氏地震規模
里氏规模	芮氏規模
里氏震级	芮氏規模
当且仅当	若且唯若
味美思	苦艾酒
毛里塔尼亚	茅利塔尼亞
毛里塔尼亞	茅利塔尼亞
霍尔木兹	荷姆茲
霍爾木茲	荷姆茲
霍尼亚拉	荷尼阿拉
霍尼亞拉	荷尼阿拉
荷里活廣場	荷里活廣場
荷里活道	荷里活道
莫桑比克	莫三比克
瓦文萨	華勒沙
華里沙	華勒沙
瓦格纳	華格納
烟具	菸具
煙具	菸具
烟品	菸品
煙品	菸品
烟嘴	菸嘴
煙嘴	菸嘴
烟卷	菸捲
煙捲	菸捲
烟斗	菸斗
煙斗	菸斗
烟民	菸民
煙民	菸民
烟灰	菸灰
煙灰	菸灰
烟瘾	菸癮
煙癮	菸癮
烟丝	菸絲
煙絲	菸絲
烟草	菸草
煙草	菸草
烟叶	菸葉
煙葉	菸葉
烟蒂	菸蒂
煙蒂	菸蒂
烟袋	菸袋
煙袋	菸袋
烟农	菸農
煙農	菸農
烟酒	菸酒
煙酒	菸酒
烟头	菸頭
煙頭	菸頭
烟鬼	菸鬼
煙鬼	菸鬼
烟碱	菸鹼
煙鹼	菸鹼
万历朝鲜战争	萬曆朝鮮戰爭
瓦努阿图	萬那杜
瓦努阿圖	萬那杜
叶利钦	葉爾欽
葉利欽	葉爾欽
埃里温	葉里溫
埃里溫	葉里溫
也門	葉門
也门	葉門
着	著
着眼于	著眼於
科摩罗	葛摩
科摩羅	葛摩
格林美獎	葛萊美獎
格莱美奖	葛萊美獎
黑山共和国	蒙特內哥羅共和國
黑山共和國	蒙特內哥羅共和國
蒙特利尔	蒙特婁
蒙特利爾	蒙特婁
普密蓬	蒲美蓬
布隆迪	蒲隆地
圭亚那	蓋亞那
基地组织	蓋達組織
阿爾蓋達組織	蓋達組織
肖斯塔科维奇	蕭士塔高維奇
蕭士達高維契	蕭士塔高維奇
肖邦	蕭邦
薛定谔	薛丁格
扎伊尔	薩伊
扎伊爾	薩伊
素檀	蘇丹
苏里南	蘇利南
蘇里南	蘇利南
浮罗交怡	蘭卡威
浮羅交怡	蘭卡威
劳拉	蘿拉
虚拟现实	虛擬實境
荧光	螢光
荧屏	螢屏
行人路权	行人路權
行人路權	行人路權
流動作業系統	行動作業系統
移动操作系统	行動作業系統
流動應用程式	行動應用程式
移动应用程序	行動應用程式
流動支付	行動支付
移动支付	行動支付
流動網絡	行動網路
移动网络	行動網路
流動互聯網	行動網際網路
移动互联网	行動網際網路
流動裝置	行動裝置
移动设备	行動裝置
流動電話	行動電話
移动电话	行動電話
冲着	衝著
埃塞俄比亚	衣索比亞
埃塞俄比亞	衣索比亞
佩洛西	裴洛西
克隆人	複製人
国际象棋	西洋棋
國際象棋	西洋棋
赫梯	西臺
分辨率	解析度
解像度	解析度
译码	解碼
触摸屏	觸控螢幕
出租车	計程車
约翰逊	詹森
努瓦克肖特	諾克少
诺曼底	諾曼第
瑙魯	諾魯
瑙鲁	諾魯
科特迪瓦	象牙海岸
碧咸	貝克漢
貝寧共和國	貝南共和國
贝宁共和国	貝南共和國
貝爾格萊德	貝爾格勒
贝尔格莱德	貝爾格勒
伯利兹	貝里斯
伯利茲	貝里斯
首席财务官	財務長
集装箱	貨櫃
数据库	資料庫
數據庫	資料庫
信息时代	資訊時代
信息论	資訊理論
乔布斯	賈伯斯
本·拉登	賓·拉登
宾西法尼亚	賓夕法尼亞
本拉登	賓拉登
利比里亚	賴比瑞亞
利比里亞	賴比瑞亞
莱索托	賴索托
萊索托	賴索托
塞浦路斯	賽普勒斯
赫丘勒·波洛	赫丘勒·白羅
赫鲁晓夫	赫魯雪夫
跳樑小丑	跳梁小丑
切尔诺贝利	車諾比
软驱	軟碟機
軟件	軟體
软件	軟體
津巴布韋	辛巴威
津巴布韦	辛巴威
德特里克堡	迪特里克堡
径入	逕入
径到	逕到
径取	逕取
径启	逕啟
径寄	逕寄
径庭	逕庭
径往	逕往
径自	逕自
径行	逕行
径迎	逕迎
链接	連結
連結他	連結他
进制	進位
道琼斯	道瓊
道瓊斯	道瓊
达·芬奇	達·文西
达芬奇	達文西
溫納圖萬	那杜
丘吉尔	邱吉爾
多普勒	都卜勒
酰	醯
里士满	里奇蒙
金沙萨	金夏沙
金沙薩	金夏沙
健力士世界紀錄	金氏世界紀錄
健力士世界纪录	金氏世界紀錄
吉尼斯世界纪录	金氏世界紀錄
钚	鈽
鈎	鉤
钩	鉤
锎	鉲
锫	鉳
镅	鋂
鋼樑	鋼梁
镎	錼
钫	鍅
炼金	鍊金
锻炼	鍛鍊
锝	鎝
鐵杆	鐵桿
铁杆	鐵桿
泰坦尼克号	鐵達尼號
锿	鑀
关系着	關係著
写保护	防寫
阿布扎比	阿布達比
阿拉伯联合酋长国	阿拉伯聯合大公國
阿拉伯聯合酋長國	阿拉伯聯合大公國
亚拉巴马	阿拉巴馬
阿联酋	阿聯
阿聯酋	阿聯
亚的斯亚贝巴	阿迪斯阿貝巴
亞的斯亞貝巴	阿迪斯阿貝巴
罗纳德·里根	隆納·雷根
私隱	隱私
耶加達	雅加達
雅尔塔	雅爾達
雅爾塔	雅爾達
雅穆苏克雷	雅穆索戈
雅穆蘇克雷	雅穆索戈
雕樑畫棟	雕梁畫棟
悉尼	雪梨
雪茄烟	雪茄菸
雪茄煙	雪茄菸
莱特湾	雷伊泰灣
萊特灣	雷伊泰灣
激光	雷射
雷诺阿	雷諾瓦
电子烟	電子菸
電子煙	電子菸
晶体管	電晶體
晶體管	電晶體
电杆	電桿
电线杆	電線桿
电脑程序	電腦程式
计算机程序	電腦程式
电脑网络	電腦網路
電腦網絡	電腦網路
荷尔斯泰因	霍爾斯坦
荷爾斯泰因	霍爾斯坦
面包着	面包著
朝鲜战争	韓戰
声卡	音效卡
缺省	預設
导弹	飛彈
糊口	餬口
香烟	香菸
香煙	香菸
馬里共和國	馬利共和國
马里共和国	馬利共和國
馬拉維	馬拉威
马拉维	馬拉威
馬勒當拿	馬拉度納
马拉多纳	馬拉度納
馬斯特里赫特	馬斯垂克
马斯特里赫特	馬斯垂克
马耳他	馬爾他
馬爾代夫	馬爾地夫
马尔代夫	馬爾地夫
高清化	高畫質化
高清电视	高畫質電視
高清電視	高畫質電視
斗着	鬥著
魯賓斯·巴里切羅	魯本·巴瑞切羅
迈克尔	麥可
麦克尔	麥可
迈凯轮	麥拿輪
邁凱輪	麥拿輪
马萨诸塞	麻薩諸塞
粘膜	黏膜
戴安娜	黛安娜
狄安娜	黛安娜
点烟	點菸
點煙	點菸
霉素	黴素
鼻樑	鼻梁
