㢡	獎
㱿	殼
㸇	𤓎
䔛	檾
䚻	謠
丢	丟
争	爭
侣	侶
俣	俁
偐	贋
偬	傯
僞	偽
兌	兑
兹	茲
内	內
册	冊
冲	沖
决	決
况	況
凄	淒
凈	淨
凉	涼
减	減
凑	湊
凛	凜
删	刪
别	別
刴	剁
刹	剎
剣	劍
剥	剝
剱	劍
劎	劍
劒	劍
劔	劍
勲	勛 勳
勳	勛 勳
匀	勻
却	卻
卺	巹
卽	即
厠	廁
厢	廂
厦	廈
厨	廚
厩	廄
厮	廝
叄	叁
叙	敍
叠	疊
吕	呂
吴	吳
呐	吶
咏	詠
啓	啟
喫	吃 喫
嘘	噓
囘	回
囪	囱
囬	回
坂	阪
垜	垛
墰	罈
墻	牆
壜	罈
壷	壺
够	夠
奥	奧
奬	獎
妝	妝 粧
姗	姍
姹	奼
娱	娛
媼	媪
嬀	媯
嬝	嫋
嬷	嬤
宫	宮
尅	剋
届	屆
峥	崢
峰	峯
崘	崙
嵗	歲
幷	并
床	牀
廪	廩
弃	棄
弑	弒
强	強
彞	彝
彦	彥
悅	悦
慍	愠
慤	愨
懔	懍
戬	戩
戶	户
戸	户
抛	拋
挅	挆
挣	掙
挩	捝
挱	挲
搵	揾
携	攜
摇	搖
撑	撐
擡	抬
擧	舉
攷	考
敎	教
敓	敚
敘	敍
旂	旗
旣	既
晋	晉
晒	曬
暅	𣈶
朶	朵
柺	枴
査	查
栀	梔
栅	柵
梲	棁
棊	棋
棱	稜
椁	槨
榲	榅
横	橫
橥	櫫
橱	櫥
檩	檁
檯	枱
欅	櫸
殁	歿
殻	殼
毁	毀
氳	氲
汙	污
汚	污
汹	洶
泝	溯
泪	淚
涗	涚
涙	淚
渌	淥
溆	漵
溫	温
溼	濕
滙	匯
滚	滾
潙	溈
潜	潛
潨	潀
潴	瀦
澁	澀
灎	灩
灔	灩
灧	灩
灾	災
烟	煙
熅	煴
爲	為
狰	猙
猪	豬
猫	貓
猬	蝟
獃	呆
珐	琺
瑶	瑤
瓮	甕
産	產
畵	畫
疎	疏
疴	痾
痹	痺
瘺	瘻
癡	痴
皁	皂
盗	盜
眞	真
眦	眥
睁	睜
碕	埼
碱	鹼
禀	稟
禄	祿
秃	禿
秆	稈
秌	秋
稅	税
稆	穭
窑	窯
竈	灶
竝	並
竪	豎
笋	筍
筝	箏
簷	檐
籼	秈
粤	粵
糉	粽
糍	餈
糭	粽
絶	絕
綉	繡
綫	線
綳	繃
緑	綠
縕	緼
縧	絛
纔	才
罎	罈
羡	羨
群	羣
羴	羶
耻	恥
肴	餚
脉	脈
脚	腳
脣	唇
脫	脱
腭	齶
膃	腽
臥	卧
臺	台
舘	館
艶	豔
艷	豔
芈	羋
苘	檾
荆	荊
莅	蒞
菸	煙
蒓	蓴
蒕	蒀
蔥	葱
蔿	蒍
蕰	薀
蘊	藴
蘖	櫱
虚	虛
虬	虯
虱	蝨
蛻	蜕
衆	眾
衛	衞
衮	袞
裡	裏
覈	核
說	説
謡	謠
謭	譾
豓	豔
賫	齎
贗	贋
贜	贓
跥	跺
踊	踴
踪	蹤
踰	逾
蹰	躕
躱	躲
轀	輼
遡	溯
遥	遙
鄕	鄉
醞	醖
鉢	缽
鉤	鈎
銳	鋭
銹	鏽
鋑	鐫
録	錄
鍼	針
鎚	錘
鎭	鎮
鎸	鐫
閧	鬨
閱	閲
闘	鬥
阩	陞
陧	隉
隽	雋
静	靜
韁	繮
韵	韻
頽	頹
顔	顏
飱	飧
駡	罵
鬭	鬥
鮝	鯗
鰐	鱷
鰮	鰛
鳬	鳧
鶏	雞
鶿	鷀
鷄	雞
鷴	鷳
麫	麪
麯	麴
麵	麪
麽	麼
黄	黃
鼹	鼴
龝	秋
塀	塀
𠟱	劃
𠤉	絕
𠮡	只
𡴳	嶽
𡶓	嶽
𡶳	嶽
𡻕	歲
𢇍	絕
𣞘	杴
𣪊	殼
𣪎	愨
𣴷	挲
𤄝	灩
𤅿	灩
𤟌	獎
𤱪	畫
𤲯	畫
𥍯	鐫
𧍞	鱷
𧰚	豔
𧰟	豔
𧿘	陞
𨁠	陞
𨽶	畫
