㢡	奨
㱿	殻
㸇	𤓎
䔛	檾
䚻	謡
丢	丟
乘	乗
亂	乱
亙	亘
亞	亜
佛	仏
來	来
侣	侶
俣	俁
假	仮
偐	贋
偬	傯
傳	伝
僞	偽
價	価
儉	倹
兑	兌
兒	児
內	内
兩	両
兹	茲
册	冊
冲	沖
决	決
况	況
凄	淒
凈	浄
凉	涼
减	減
凑	湊
凛	凜
删	刪
别	別
刴	剁
剎	刹
剥	剝
剩	剰
剱	剣
劍	剣
劎	剣
劑	剤
劒	剣
劔	剣
勛	勲
勞	労
勳	勲
勵	励
勸	勧
勻	匀
區	区
卧	臥
卷	巻
卺	巹
卻	却
卽	即
厢	廂
厦	廈
厨	廚
厩	廄
厮	廝
參	参
叠	畳
吕	呂
吳	呉
吴	呉
呐	吶
咏	詠
咒	呪
啞	唖
啟	啓
單	単
噓	嘘
嚙	噛
嚴	厳
囑	嘱
囘	回
囬	回
囱	囪
圈	圏
國	国
圍	囲
圓	円
圖	図
團	団
坂	阪
垜	垛
增	増
墮	堕
墰	罈
墻	牆
壓	圧
壘	塁
壜	罈
壞	壊
壤	壌
壯	壮
壷	壺
壹	壱
壽	寿
够	夠
奧	奥
奬	奨
妝	粧
姗	姍
姹	奼
娱	娛
媪	媼
媯	嬀
嬝	嫋
嬷	嬤
孃	嬢
學	学
宫	宮
寢	寝
實	実
寫	写
寬	寛
寶	宝
尅	剋
將	将
專	専
對	対
屆	届
屬	属
峥	崢
峯	峰
峽	峡
崘	崙
嵗	歳
嶽	岳
巖	巌
巢	巣
帶	帯
幷	并
廁	厠
廢	廃
廣	広
廪	廩
廳	庁
弃	棄
弑	弒
强	強
彈	弾
彌	弥
彎	弯
彞	彝
彥	彦
徑	径
從	従
徵	徴
德	徳
恆	恒
悅	悦
惠	恵
惡	悪
惱	悩
愠	慍
慘	惨
慤	愨
應	応
懔	懍
懷	懐
戀	恋
戬	戩
戰	戦
戲	戯
戶	戸
户	戸
戾	戻
抛	拋
拂	払
拔	抜
拜	拝
挅	挆
挣	掙
挱	挲
挾	挟
插	挿
揭	掲
搔	掻
搖	揺
搜	捜
携	攜
摇	揺
摑	掴
撑	撐
擇	択
擊	撃
擔	担
據	拠
擧	挙
擴	拡
攝	摂
攪	撹
收	収
攷	考
效	効
敍	叙
敎	教
敕	勅
敘	叙
數	数
斷	断
旂	旗
旣	既
晉	晋
晒	曬
晚	晩
晝	昼
暅	𣈶
暨	曁
曆	暦
曉	暁
曾	曽
會	会
朶	朵
枡	桝
枴	柺
查	査
栀	梔
栅	柵
條	条
棁	梲
棊	棋
棧	桟
棱	稜
椁	槨
榅	榲
榆	楡
榮	栄
樂	楽
樓	楼
樞	枢
樣	様
橥	櫫
橫	横
橱	櫥
檢	検
檩	檁
櫻	桜
欅	櫸
權	権
歐	欧
歡	歓
步	歩
歲	歳
歷	歴
歸	帰
殁	歿
殘	残
殼	殻
毁	毀
毆	殴
每	毎
氣	気
氲	氳
汙	汚
污	汚
汹	洶
沒	没
泝	溯
泪	涙
涉	渉
淚	涙
淨	浄
淺	浅
渌	淥
渴	渇
溆	漵
溈	潙
溪	渓
溫	温
溼	湿
滙	匯
滚	滾
滯	滞
滿	満
潑	溌
潛	潜
潴	瀦
澀	渋
澁	渋
澤	沢
濕	湿
濟	済
濤	涛
濱	浜
濾	沪
瀧	滝
瀨	瀬
灎	灩
灔	灩
灣	湾
灧	灩
灶	竃
灾	災
烟	煙
焰	焔
煴	熅
燈	灯
燒	焼
營	営
爐	炉
爭	争
爲	為
牀	床
犧	犠
狀	状
狰	猙
狹	狭
猪	豬
猬	蝟
獃	呆
獎	奨
獨	独
獵	猟
獸	獣
獻	献
珐	琺
瑶	瑤
瓣	弁
瓮	甕
產	産
畫	画
畵	画
當	当
疊	畳
疏	疎 疏
疴	痾
痹	痺
瘦	痩
瘺	瘻
癡	痴
發	発
皋	皐
盜	盗
盡	尽
眞	真
眦	眥
眾	衆
睁	睜
碎	砕
碕	埼
碱	鹸
祕	秘
祿	禄
禀	稟
禦	御
禪	禅
禮	礼
禱	祷
秃	禿
秆	稈
秌	秋
稅	税
稆	穭
稱	称
稻	稲
穎	頴
穗	穂
穩	穏
穰	穣
窑	窯
竈	竃
竊	窃
竝	並
竪	豎
笋	筍
筝	箏
簷	檐
籼	秈
粤	粵
粹	粋
糉	粽
糍	餈
糭	粽
絕	絶
絲	糸
綉	繍
經	経
綠	緑
綫	線
綳	繃
緖	緒
緣	縁
緼	縕
縣	県
縧	絛
縱	縦
總	総
繡	繍
繩	縄
繪	絵
繫	繋
繼	継
續	続
纔	才
纖	繊
缺	欠
缽	鉢
罎	罈
罐	缶
羡	羨
羣	群
羴	羶
耻	恥
聯	連
聰	聡
聲	声
聽	聴
肅	粛
肴	餚
脉	脈
脣	唇
脫	脱
腦	脳
腭	齶
腳	脚
腽	膃
膽	胆
臟	臓
臺	台
與	与
舉	挙
舊	旧
舍	舎
舘	館
艷	艶
芈	羋
苘	檾
荆	荊
荔	茘
莅	蒞
莊	荘
莖	茎
菸	煙
萊	莱
萬	万
蒍	蔿
蒓	蓴
蔣	蒋
蔥	葱
蕰	薀
薰	薫
藏	蔵
藝	芸
藥	薬
藴	蘊
蘆	芦
蘖	櫱
處	処
虛	虚
號	号
虬	虯
虱	蝨
蜕	蛻
螢	蛍
蟲	虫
蠟	蝋
蠶	蚕
蠻	蛮
衮	袞
裝	装
裡	裏
覺	覚
覽	覧
觀	観
觸	触
說	説
謠	謡
謭	譾
證	証
譯	訳
譽	誉
讀	読
變	変
讓	譲
豐	豊
豓	艶
豔	艶
豫	予
貓	猫
貳	弐
賣	売
賫	齎
賴	頼
贊	賛
贗	贋
贜	贓
跥	跺
踐	践
踪	蹤
踰	逾
踴	踊
蹰	躕
躱	躲
輕	軽
輛	輌
輼	轀
轉	転
辨	弁
辭	辞
辯	弁
遙	遥 遙
遞	逓
遡	溯
遥	遥 遙
遲	遅
邊	辺
鄉	郷
鄕	郷
酢	醋
醉	酔
醖	醞
醫	医
醬	醤
醱	醗
釀	醸
釋	釈
鈎	鉤
銹	鏽
鋑	鐫
鋪	舗
鋭	銳
錄	録
錢	銭
鍊	錬
鎚	錘
鎭	鎮
鎸	鐫
鐵	鉄
鑄	鋳
鑛	鉱
閧	鬨
閱	閲
關	関
阩	陞
陧	隉
陷	陥
隨	随
險	険
隱	隠
隽	雋
雙	双
雜	雑
雞	鶏
霸	覇
靈	霊
靜	静
韁	繮
韵	韻
頽	頹
顏	顔
顯	顕
飱	飧
餘	余
駡	罵
騷	騒
驅	駆
驗	験
驛	駅
髓	髄
體	体
髮	髪
鬥	闘
鬭	闘
鮝	鯗
鰐	鱷
鰛	鰮
鱉	鼈
鳬	鳧
鶿	鷀
鷄	鶏
鷗	鴎
鷴	鷳
鹼	鹸
鹽	塩
麥	麦
麪	麺
麫	麺
麯	麹
麴	麹
麵	麺
麽	麼
黃	黄
黑	黒
默	黙
點	点
黨	党
鼹	鼴
齊	斉
齋	斎
齒	歯
齡	齢
龍	竜
龜	亀
龝	秋
塀	塀
𠟱	劃
𠤉	絶
𠮡	只
𡴳	岳
𡶓	岳
𡶳	岳
𡻕	歳
𢇍	絶
𣞘	杴
𣪊	殻
𣪎	愨
𣴷	挲
𤄝	灩
𤅿	灩
𤟌	奨
𤱪	画
𤲯	画
𥍯	鐫
𧍞	鱷
𧰚	艶
𧰟	艶
𧿘	陞
𨁠	陞
𨽶	画
