㑮	𫝈
㑯	㑔
㑶	㐹
㒓	𠉂
㓄	𪠟
㓨	刾
㔋	𪟎
㖮	𪠵
㗲	𠵾
㗿	𪡛
㘉	𠰱
㘓	𪢌
㘔	𫬐
㛝	𫝦
㜄	㚯
㜏	㛣
㜐	𫝧
㜗	𡞋
㜢	𡞱
㜷	𡝠
㞞	𪨊
㟺	𪩇
㠏	㟆
㢗	𪪑
㢝	𢋈
㦎	𢛯
㦛	𢗓
㦞	𪫷
㨻	𪮃
㩋	𪮋
㩜	㨫
㩵	擜
㪎	𪯋
㯤	𣘐
㰙	𣗙
㵗	𣳆
㵾	𪷍
㶆	𫞛
㷍	𤆢
㷿	𤈷
㸇	𤎺
㹽	𫞣
㺏	𤠋
㺜	𪺻
㻶	𪼋
㿖	𪽮
㿗	𤻊
㿧	𤽯
䀉	𥁢
䀹	𥅴
䁪	𥇢
䁻	䀥
䂎	𥎝
䅐	𫀨
䅳	𫀬
䆉	𫁂
䉑	𫁲
䉙	𥬀
䉬	𫂈
䉲	𥮜
䉶	𫁷
䊭	𥺅
䊷	䌶
䊺	𫄚
䋃	𫄜
䋔	𫄞
䋙	䌺
䋚	䌻
䋦	𫄩
䋹	䌿
䋻	䌾
䋼	𫄮
䋿	𦈓
䌈	𦈖
䌋	𦈘
䌖	𦈜
䌝	𦈟
䌟	𦈞
䌥	𦈠
䌰	𦈙
䍤	𫅅
䍦	䍠
䍽	𦍠
䎙	𫅭
䎱	䎬
䕤	𫟕
䕳	𦰴
䖅	𫟑
䗅	𫊪
䗿	𧉞
䙔	𫋲
䙡	䙌
䙱	𧜭
䚩	𫌯
䛄	𫍠
䛳	𫍫
䜀	䜧
䜖	𫟢
䝭	𫎧
䝻	𧹕
䝼	䞍
䞈	𧹑
䞋	𫎪
䞓	𫎭
䟃	𫎺
䟆	𫎳
䟐	𫎱
䠆	𫏃
䠱	𨅛
䡐	𫟤
䡩	𫟥
䢨	𨑹
䤤	𫟺
䥄	𫠀
䥇	䦂
䥗	𫔋
䥩	𨱖
䥯	𫔆
䥱	䥾
䦘	𨸄
䦛	䦶
䦟	䦷
䦯	𫔵
䦳	𨷿
䧢	𨸟
䪊	𫖅
䪏	𩏼
䪗	𩐀
䪘	𩏿
䪴	𫖫
䪾	𫖬
䫀	𫖱
䫂	𫖰
䫟	𫖲
䫴	𩖗
䫶	𫖺
䫻	𫗇
䫾	𫠈
䬓	𫗊
䬘	𩙮
䬝	𩙯
䬞	𩙧
䬧	𫗟
䭀	𩠇
䭃	𩠈
䭑	𫗱
䭔	𫗰
䭿	𩧭
䮝	𩧰
䮞	𩨁
䮠	𩧿
䮫	𩨇
䮰	𫘮
䮳	𩨏
䮾	𩧪
䯀	䯅
䯤	𩩈
䱀	𫚐
䱁	𫚏
䱙	𩾈
䱧	𫚠
䱬	𩾊
䱰	𩾋
䱷	䲣
䱸	𫠑
䱽	䲝
䲅	𫚜
䲖	𩾂
䲰	𪉂
䳜	𫛬
䳢	𫛰
䳤	𫛮
䳧	𫛺
䳫	𫛼
䴋	𫜅
䴬	𪎈
䴱	𫜒
䴴	𪎋
䴽	𫜔
䵳	𪑅
䵴	𫜙
䶕	𫜨
䶲	𫜳
俓	𠇹
俥	伡
倲	㑈
偑	㐽
傌	㐷
儎	傤
儘	侭
儣	𠆲
儭	𠋆
儸	㑩
凙	𪞝
剾	𠛅
劃	㓰
劏	㓥
劚	㔉
勑	𠡠
哯	𠯟
唓	𪠳
啢	唡
喎	㖞
嗰	𠮶
嗹	𪡏
嘓	啯
嘪	𪡃
嘳	𪡞
嘺	𪡀
噅	𠯠
噚	㖊
噞	𪡋
噹	𪠽
嚌	哜
嚛	𪠸
嚧	𠰷
嚽	𪢕
囃	𠱞
囒	𪢠
圞	𪢮
埬	𪣆
堚	𪣒
墲	𪢸
壈	𡒄
壗	𡋤
壠	垅
壣	𪤚
婡	𫝫
媈	𫝨
媰	㛀
嬇	𫝬
嬣	𪥰
嬦	𫝩
嬻	𪥿
孄	𫝮
孆	𫝭
孇	𪥫
孋	㛤
孎	𡠟
孻	𡥧
孾	𪧀
寠	𪧘
屩	𪨗
崙	𪨧
嵼	𡶴
嵾	㟥
嶈	𡺃
嶘	𡺄
嶹	𫝵
巊	𪩎
巗	𪨷
幓	㡎
幝	𪩷
幩	𪩸
廧	𪪞
廬	𪪏
弳	弪
彃	𪪼
彲	彨
徿	𪫌
悞	悮
愻	𢙏
慺	㥪
憢	𢙒
憸	𪫺
憹	𢙐
懀	𢙓
懎	𢠁
懤	㤽
戰	𢧐
戱	戯
挩	捝
掆	㧏
掗	挜
掚	𪭵
揯	搄
搵	揾
摋	𢫬
摐	𪭢
撊	𪭾
撟	挢
撧	𪮖
擟	𪭧
擣	𢭏
擫	𢬍
擽	㧰
攋	𪮶
敓	敚
斅	𢽾
斸	𣃁
曊	𪰶
曥	𣆐
朥	𦛨
桱	𣐕
梖	𪱷
椲	㭏
楇	𣒌
槫	𣏢
槮	椮
槶	椢
槼	椝
樠	𣗊
樢	㭤
樤	𣔌
樧	榝
樫	㭴
樳	桪
樿	椫
橯	𣓿
檭	𣘴
檵	𪲛
櫅	𪲎
櫠	𪲮
欇	𪳍
欍	𣐤
欐	𪲔
欑	𪴙
欘	𣚚
殢	𣨼
殨	㱮
殰	㱩
毊	𪵑
氭	𣱝
涗	涚
溡	𪶄
潚	㴋
潣	𫞗
澅	𣶩
澩	泶
澬	𫞚
澾	㳠
濄	㳡
濧	㳔
濿	𪵱
瀃	𣽷
瀇	㲿
瀋	渖
瀰	㳽
灍	𫞝
灒	𪷽
灙	𣺼
灡	㳕
煇	𪸩
煱	㶽
熂	𪸕
熉	𤈶
熌	𤇄
熓	𤆡
熚	𤇹
熡	𤋏
燶	㶶
爃	𫞡
爄	𤇃
爇	𦶟
爖	𤇭
爥	𪹳
爧	𫞠
牴	牴
犞	𪺭
猌	𪺽
獊	𪺷
獩	𤞃
獱	㺍
玁	𤞤
珼	𫞥
瑻	𪻲
瑽	𪻐
璝	𪻺
璯	㻅
璸	瑸
璼	𫞨
璾	𫞦
瓄	𪻨
瓕	𤦀
畼	𪽈
痮	𪽪
瘂	痖
瘱	𪽷
癐	𤶊
皟	𤾀
盨	𪾔
眝	𪾣
瞤	𥆧
瞶	瞆
矉	𪾸
矑	𪾦
碙	𥐻
碽	䂵
磠	硵
礆	硷
礒	𥐟
礮	𪿫
稏	䅉
穭	穞
竚	𥩟
竱	𫁟
筴	䇲
篘	𥬠
篠	筿
篸	𥮾
簂	𫂆
簢	𫂃
籅	𥫣
籋	𥬞
籔	䉤
糹	纟
糺	𫄙
紟	𫄛
紬	䌷
絁	𫄟
絍	𫟃
絙	𫄠
絥	𫄢
絧	𫄡
綀	𦈌
綇	𦈋
綋	𫟄
綐	䌼
綞	缍
綟	𫄫
綵	䌽
緍	𦈏
緓	绬
緟	𫟆
緤	𫄬
緮	𫄭
緰	𦈕
緶	缏
緷	𦈉
緸	𦈑
縍	𫄰
縎	𦈔
縬	𦈚
縰	𫄳
縳	䌸
縸	𫄲
縺	𦈐
繂	𫄴
繈	𫄶
繏	𦈝
繐	𰬸
繓	𦈛
繟	𦈎
繢	缋
繨	𫄤
繬	𫄱
繷	𫄣
繸	䍁
繿	䍀
纇	颣
纗	𫄹
纚	𫄥
羵	𫅗
聻	𫆏
脥	𣍰
腪	𣍯
膹	𪱥
臗	𣎑
艣	𫇛
菕	𰰨
萴	荝
葝	𫈎
蒕	蒀
蒭	𫇴
蓧	𦰏
蔯	𫈟
蕝	𫈵
蕳	𫈉
蕽	𫇽
薆	𫉁
薳	䓕
薵	䓓
藷	𫉄
蘟	𦻕
虆	蔂
螿	螀
蟂	𫋇
蟘	𫋌
蟜	𫊸
蟳	𫊻
蠀	𧏗
蠁	蚃
蠙	𧏖
蠦	𫊮
蠾	𧑏
衹	衹
襓	𫋹
襗	𫋷
襘	𫋻
襬	䙓
襰	𧝝
襵	𫌇
覛	𫌪
覥	觍
覹	𫌭
覼	𫌨
訁	讠
訑	𫍙
託	讬
訜	𫍛
訞	𫍚
訨	𫟞
詀	𧮪
詊	𫟟
詑	𫍡
詓	𫍜
誂	𫍥
誋	𫍪
誒	诶
誫	𫍨
誳	𫍮
誴	𫟡
誷	𫍬
誺	𫍧
諣	𫍩
諥	𫍳
諫	𫍝
諮	谘
諯	𫍱
諰	𫍰
謆	𫍸
謉	𫍷
謯	𫍹
謱	𫍴
謸	𫍵
譂	𫟠
譅	𰶎
譆	𫍻
譊	𫍢
譑	𫍤
譨	𫍦
譸	诪
譾	𫍿
讅	谉
讌	䜩
豵	𫎆
貗	𫎌
貟	贠
買	𧹒
賝	𫎩
賟	𧹖
賰	䞐
贃	𧹗
贉	𫎫
贑	𫎬
贚	𫎦
蹔	𫏐
蹳	𫏆
蹻	𫏋
躎	䟢
躘	𨀁
躝	𨅬
軉	𨉗
軕	𫐅
軗	𨐅
軜	𫐇
軨	𫐉
軬	𫐊
軷	𫐈
軿	𫐌
輖	𫐏
輢	𫐎
輨	𫐑
輷	𫐒
轇	𫐖
轊	𫐕
轐	𫐗
轗	𫐘
轠	𫐙
轣	𫐆
遱	𫐷
鄟	𫑘
醟	蒏
醶	𫑷
釒	钅
釚	𫟲
釟	𫓥
釨	𫓦
釲	𫟳
釳	𨰿
釾	䥺
鈆	𫓪
鈋	𨱂
鈒	钑
鈖	𫟴
鈗	𫟵
鈛	𫓨
鈠	𨱁
鈯	𨱄
鈲	𨱃
鈳	钶
鈽	钸
鉁	𨱅
鉋	铇
鉔	𫓬
鉝	𫟷
鉠	𫓭
鉽	𫟸
鉾	𫓴
銁	𫓲
銂	𫟻
銊	𫓰
銏	𫟶
銛	铦
鋂	𰾄
鋉	𨱈
鋠	𫓵
鋩	铓
錂	𨱋
錏	铔
錜	𫓻
錝	𫓽
錥	𫓾
錩	锠
錽	𫓸
鍄	𨱉
鍉	𫔂
鍊	𫔀
鍒	𫔄
鍮	𨱎
鎈	𫟿
鎍	𫔅
鎙	𫔈
鎞	𫔇
鎯	𨱍
鎶	鿔
鎷	𨰾
鏆	𨱌
鏇	镟
鏉	𨱒
鏍	镙
鏚	𬭭
鏥	𫔊
鏦	𫓩
鏾	𫔌
鐈	𫓱
鐎	𨱓
鐥	䦅
鐪	𫓺
鐼	𫔁
鑀	𰾭
鑉	𫠁
鑴	𫔔
钁	䦆
閈	闬
開	𫔭
閍	𨸂
閐	𨸃
閒	𫔮
閗	𫔯
閝	𫠂
閞	𫔰
閵	𫔴
闠	阓
闤	阛
隯	陦
霢	霡
霣	𫕥
霼	𪵣
靝	靔
靦	䩄
靧	𫖃
鞾	𫖇
韚	𫠅
韛	𫖔
韝	𫖕
韠	𫖒
頮	颒
頴	颕
顂	𩓋
顃	𩖖
顅	𫖶
願	𫖸
顣	𫖹
颰	𩙥
颷	𩙪
颻	飖
颾	𩙫
飈	飚
飋	𫗋
飠	饣
飣	饤
飥	饦
飦	𫗞
飵	𫗢
飶	𫗣
餔	𫗦
餕	馂
餖	饾
餘	馀
餦	𫗠
餧	𫗪
餪	𫗬
餫	𫗥
餬	𫗫
餭	𫗮
餱	𫗯
餵	𫗭
餸	𩠌
餺	馎
饟	𫗵
饠	𫗩
馯	𫘛
駊	𫘟
駎	𩧨
駚	𩧫
駞	𫘞
駤	𫘠
駧	𩧲
駩	𩧴
駫	𫘡
駶	𩧺
駻	𫘣
騃	𫘤
騉	𫘥
騌	骔
騔	𩨀
騚	𩨊
騜	𫘩
騝	𩨃
騟	𩨈
騧	䯄
騪	𩨄
騴	𫘫
騻	𫘭
騼	𫠋
驄	𩨂
驋	𩧯
驓	𫘯
驙	𫘰
驨	𫘱
鬖	𩭹
鬠	𫘽
魟	𫚉
魥	𩽹
魦	𫚌
魵	𫚍
魺	鲄
魽	𫠐
鮄	𫚒
鮅	𫚑
鮤	𫚓
鮯	𫚗
鮰	𫚔
鮳	鲓
鮵	𫚛
鮿	𫚚
鯄	𩾁
鯆	𫚙
鯞	𫚡
鯬	𫚞
鯰	鲶
鯱	𩾇
鯶	𩽼
鯾	𫚣
鰋	𫚢
鰌	䲡
鰑	𫚊
鰒	鳆
鰕	𫚥
鰠	鳋
鰦	𫚤
鰫	𫚦
鰽	𫚧
鱄	𫚋
鱆	𫠒
鱊	𫚪
鱢	𫚫
鱮	𫚈
鳷	𫛛
鳼	𪉃
鳽	𫛚
鴀	𫛜
鴃	𫛞
鴅	𫛝
鴐	𫛤
鴔	𫛡
鴗	𫁡
鴜	𪉈
鴥	𫛣
鴮	𫛦
鴲	𪉆
鴳	𫛩
鴽	𫛪
鵊	𫛥
鵚	𪉍
鵧	𫛨
鵩	𫛳
鵫	𫛱
鵰	𫛲
鵷	鹓
鶌	𫛵
鶒	𫛶
鶗	𫛸
鶦	𫛷
鶭	𫛯
鶰	𫛫
鷅	𫛽
鷐	𫜀
鷔	𪉑
鷖	鹥
鷣	𫜃
鷤	𫛴
鷨	𪉊
鷩	𫜁
鷷	𫜄
鷽	鸴
鷿	𬸯
鸂	㶉
鸋	𫛢
鸗	𫛟
麨	𪎊
麪	𮮄
麬	𤿲
麲	𪎉
麳	𪎌
麵	麺
麷	𫜑
鼂	鼌
齧	𫜩
齩	𫜪
齭	𫜭
齰	𫜬
齴	𫜮
齾	𫜰
龎	厐
龓	𫜲
龭	𩨎
龯	𨱆
鿁	䜤
鿓	鿒
𠁞	𠀾
𠌥	𠆿
𠏢	𠉗
𠐊	𫝋
𠗣	㓆
𠞆	𠛆
𠠎	𠚳
𠬙	𪠡
𠽃	𪠺
𠿕	𪜎
𡂡	𪢒
𡃄	𪡺
𡃕	𠴛
𡃤	𪢐
𡄔	𠴢
𡄣	𠵸
𡅏	𠲥
𡅯	𪢖
𡑭	𡋗
𡓁	𪤄
𡓾	𡋀
𡔖	𡍣
𡞵	㛟
𡟫	𫝪
𡠹	㛿
𡢃	㛠
𡮉	𡭜
𡮣	𡭬
𡳳	𡳃
𡸗	𪨩
𡹬	𪨹
𡽗	𡸃
𡾱	㟜
𡿖	𪩛
𢍰	𪪴
𢠼	𢙑
𢣐	𪬚
𢣚	𢘝
𢣭	𢘞
𢤩	𪫡
𢤱	𢘙
𢤿	𪬯
𢯷	𪭝
𢶒	𪭯
𢶫	𢫞
𢷮	𢫊
𢹿	𢬦
𢺳	𪮳
𣋋	𣈣
𣍐	𫧃
𣙎	㭣
𣜬	𪳗
𣝕	𣘷
𣞻	𣘓
𣠩	𣞎
𣠲	𣑶
𣯩	𣯣
𣯴	𣭤
𣯶	毶
𣽏	𪶮
𣾷	㳢
𣿉	𣶫
𤁣	𣺽
𤄷	𪶒
𤅶	𣷷
𤑳	𤎻
𤑹	𪹀
𤒎	𤊀
𤒻	𪹹
𤓌	𪹠
𤓎	𤎺
𤓩	𤊰
𤘀	𪺣
𤛮	𤙯
𤛱	𫞢
𤜆	𪺪
𤠮	𪺸
𤢟	𤝢
𤢻	𢢐
𤩂	𫞧
𤪺	㻘
𤫩	㻏
𤬅	𪼴
𤳷	𪽝
𤳸	𤳄
𤷃	𪽭
𤸫	𤶧
𤺔	𪽴
𥊝	𥅿
𥌃	𥅘
𥏝	𪿊
𥕥	𥐰
𥖅	𥐯
𥖲	𪿞
𥗇	𪿵
𥜐	𫀓
𥜰	𫀌
𥞵	𥞦
𥢢	䅪
𥢶	𫞷
𥢷	𫀮
𥨐	𥧂
𥪂	𥩺
𥯤	𫁳
𥴨	𫂖
𥴼	𫁺
𥵃	𥱔
𥵊	𥭉
𥶽	𫁱
𥸠	𥮋
𥻦	𫂿
𥼽	𥹥
𥽖	𥺇
𥾯	𫄝
𥿊	𦈈
𦀖	𫄦
𦂅	𦈒
𦃄	𦈗
𦃩	𫄯
𦅇	𫄪
𦅈	𫄵
𦆲	𫟇
𦒀	𫅥
𦔖	𫅼
𦘧	𡳒
𦟼	𫆝
𦠅	𫞅
𦡝	𫆫
𦢈	𣍨
𦣎	𦟗
𦧺	𫇘
𦪙	䑽
𦪽	𦨩
𦱌	𫇪
𦾟	𦶻
𧎈	𧌥
𧒯	𫊹
𧔥	𧒭
𧕟	𧉐
𧜗	䘞
𧜵	䙊
𧝞	䘛
𧞫	𫌋
𧟀	𧝧
𧡴	𫌫
𧢄	𫌬
𧦝	𫍞
𧦧	𫍟
𧩕	𫍭
𧩙	䜥
𧩼	𫍶
𧫝	𫍺
𧬤	𫍼
𧭈	𫍾
𧭹	𫍐
𧳟	𧳕
𧵳	䞌
𧶔	𧹓
𧶧	䞎
𧷎	𪠀
𧸘	𫎨
𧹈	𪥠
𧽯	𫎸
𨂐	𫏌
𨄣	𨀱
𨅍	𨁴
𨆪	𫏕
𨇁	𧿈
𨇞	𨅫
𨇤	𫏨
𨇰	𫏞
𨇽	𫏑
𨈊	𨂺
𨈌	𨄄
𨊰	䢀
𨊸	䢁
𨊻	𨐆
𨋢	䢂
𨌈	𫐍
𨍰	𫐔
𨎌	𫐋
𨎮	𨐉
𨏠	𨐇
𨏥	𨐊
𨞺	𫟫
𨟊	𫟬
𨢿	𨡙
𨣈	𨡺
𨣞	𨟳
𨣧	𨠨
𨤻	𨤰
𨥛	𨱀
𨥟	𫓫
𨦫	䦀
𨧜	䦁
𨧰	𫟽
𨧱	𨱊
𨨛	𫓼
𨨢	𫓿
𨩰	𫟾
𨪕	𫓮
𨫒	𨱐
𨬖	𫔏
𨭖	𫔑
𨭸	𫔐
𨮂	𨱕
𨮳	𫔒
𨯅	䥿
𨯟	𫔓
𨰃	𫔉
𨰋	𫓳
𨰥	𫔕
𨰲	𫔃
𨲳	𫔖
𨳑	𨸁
𨳕	𨸀
𨴗	𨸅
𨴹	𫔲
𨵩	𨸆
𨵸	𨸇
𨶀	𨸉
𨶏	𨸊
𨶮	𨸌
𨶲	𨸋
𨷲	𨸎
𨼳	𫔽
𨽏	𨸘
𩀨	𫕚
𩅙	𫕨
𩎖	𫖑
𩎢	𩏾
𩏂	𫖓
𩏠	𫖖
𩏪	𩏽
𩏷	𫃗
𩑔	𫖪
𩒎	𫖭
𩓣	𩖕
𩓥	𫖵
𩔑	𫖷
𩔳	𫖴
𩖰	𫠇
𩗀	𩙦
𩗓	𫗈
𩗴	𫗉
𩘀	𩙩
𩘝	𩙭
𩘹	𩙨
𩘺	𩙬
𩙈	𩙰
𩚛	𩟿
𩚥	𩠀
𩚩	𫗡
𩚵	𩠁
𩛆	𩠂
𩛌	𫗤
𩛡	𫗨
𩛩	𩠃
𩜇	𩠉
𩜦	𩠆
𩜵	𩠊
𩝔	𩠋
𩝽	𫗳
𩞄	𩠎
𩞦	𩠏
𩞯	䭪
𩟐	𩠅
𩟗	𫗚
𩠴	𩠠
𩡣	𩡖
𩡺	𩧦
𩢡	𩧬
𩢴	𩧵
𩢸	𩧳
𩢾	𩧮
𩣏	𩧶
𩣑	䯃
𩣫	𩧸
𩣵	𩧻
𩣺	𩧼
𩤊	𩧩
𩤙	𩨆
𩤲	𩨉
𩤸	𩨅
𩥄	𩨋
𩥇	𩨍
𩥉	𩧱
𩥑	𩨌
𩦠	𫠌
𩧆	𩨐
𩭙	𩬣
𩯁	𫙂
𩯳	𩯒
𩰀	𩬤
𩰹	𩰰
𩳤	𩲒
𩴵	𩴌
𩵦	𫠏
𩵩	𩽺
𩵹	𩽻
𩶁	𫚎
𩶘	䲞
𩶰	𩽿
𩶱	𩽽
𩷰	𩾄
𩸃	𩾅
𩸄	𫚝
𩸡	𫚟
𩸦	𩾆
𩻗	𫚨
𩻬	𫚩
𩻮	𫚘
𩼶	𫚬
𩽇	𩾎
𩿅	𫠖
𩿤	𫛠
𩿪	𪉄
𪀖	𫛧
𪀦	𪉅
𪀾	𪉋
𪁈	𪉉
𪁖	𪉌
𪂆	𪉎
𪃍	𪉐
𪃏	𪉏
𪃒	𫛻
𪃧	𫛹
𪄆	𪉔
𪄕	𪉒
𪅂	𫜂
𪆷	𫛾
𪇳	𪉕
𪈼	𱊜
𪉸	𫜊
𪋿	𫧮
𪌭	𫜓
𪍠	𫜕
𪓰	𫜟
𪔵	𪔭
𪘀	𪚏
𪘯	𪚐
𪙏	𫜯
𪟖	𠛾
𪷓	𣶭
𫒡	𫓷
𫜦	𫜫
