㢡	獎
㱿	殼
㸇	𤓎
䔛	檾
䚻	謠
丢	丟
争	爭
侣	侶
俣	俁
偐	贗
偬	傯
僞	偽
兑	兌
兹	茲
内	內
册	冊
冲	沖
决	決
况	況
凄	淒
凈	淨
凉	涼
减	減
凑	湊
凛	凜
删	刪
别	別
刴	剁
刹	剎
剣	劍
剥	剝
剱	劍
劎	劍
劒	劍
劔	劍
勲	勛 勳
勳	勛 勳
匀	勻
卧	臥
却	卻
卺	巹
卽	即
厠	廁
厢	廂
厦	廈
厨	廚
厩	廄
厮	廝
叙	敘
叠	疊
吕	呂
吴	吳
呐	吶
咏	詠
啓	啟
喫	吃 喫
嘘	噓
囘	回
囬	回
囱	囪
坂	阪
垜	垛
墰	罈
墻	牆
壜	罈
壷	壺
够	夠
奥	奧
奬	獎
姗	姍
姹	奼
娱	娛
媪	媼
嫺	嫻
嬀	媯
嬝	嫋
嬷	嬤
宫	宮
尅	剋
届	屆
峥	崢
峯	峰
崘	崙
嵗	歲
幷	并
幺	么
廪	廩
弃	棄
弑	弒
强	強
彞	彝
彦	彥
悦	悅
愠	慍
慤	愨
懔	懍
戬	戩
户	戶
戸	戶
抛	拋
挅	挆
挣	掙
挱	挲
携	攜
摇	搖
撑	撐
擡	抬
擧	舉
攷	考
敍	敘
敎	教
旂	旗
旣	既
晋	晉
晒	曬
暅	𣈶
朶	朵
枴	柺
査	查
栀	梔
栅	柵
棁	梲
棊	棋
棱	稜
椁	槨
榅	榲
横	橫
橥	櫫
橱	櫥
檐	簷
檩	檁
欅	櫸
殁	歿
殻	殼
毁	毀
氲	氳
汚	汙
污	汙
汹	洶
泝	溯
泪	淚
涙	淚
渌	淥
温	溫
溆	漵
滙	匯
滚	滾
潙	溈
潜	潛
潨	潀
潴	瀦
澁	澀
灎	灩
灔	灩
灧	灩
灾	災
烟	煙
煴	熅
爲	為
牀	床
狰	猙
猪	豬
猫	貓
猬	蝟
獃	呆
珐	琺
瑶	瑤
瓮	甕
産	產
畵	畫
疎	疏
疴	痾
痹	痺
瘺	瘻
癡	痴
皁	皂
盗	盜
眞	真
眦	眥
着	著
睁	睜
睾	睪
碕	埼
碱	鹼
禀	稟
禄	祿
秃	禿
秆	稈
秌	秋
稆	穭
税	稅
窑	窯
竈	灶
竝	並
竪	豎
笋	筍
筝	箏
籼	秈
粤	粵
糉	粽
糍	餈
糭	粽
絶	絕
綉	繡
綫	線
綳	繃
緑	綠
緼	縕
縧	絛
繮	韁
纔	才 纔
罎	罈
羡	羨
羣	群
羴	羶
耻	恥
肴	餚
脉	脈
脚	腳
脣	唇
脱	脫
腭	顎
腽	膃
舘	館
艶	豔
艷	豔
芈	羋
苘	檾
荆	荊
莅	蒞
葱	蔥
蒓	蓴
蔘	參 蔘
蔿	蒍
蕰	薀
藴	蘊
蘖	櫱
虚	虛
虬	虯
虱	蝨
蜕	蛻
衆	眾
衮	袞
裏	裡
覈	核 覈
説	說
謡	謠
謭	譾
豓	豔
賫	齎
贋	贗
贜	贓
跥	跺
踊	踴
踪	蹤
踰	逾
蹰	躕
躱	躲
輼	轀
遡	溯
遥	遙
鄕	鄉
醖	醞
鈎	鉤
鉢	缽
銹	鏽
鋑	鐫
鋭	銳
録	錄
鍼	針 鍼
鎚	錘
鎭	鎮
鎸	鐫
閧	鬨
閲	閱
闘	鬥
阩	陞
陧	隉
隽	雋
静	靜
韵	韻
頽	頹
顔	顏
飱	飧
駡	罵
鬭	鬥
鮎	鯰
鮝	鯗
鰐	鱷
鰛	鰮
鳬	鳧
鶏	雞
鷀	鶿
鷄	雞
鷴	鷳
麪	麵
麫	麵
麽	麼
黄	黃
鼹	鼴
齶	顎
龝	秋
塀	塀
𠟱	劃
𠤉	絕
𠮡	只
𡴳	嶽
𡶓	嶽
𡶳	嶽
𡻕	歲
𢇍	絕
𣞘	杴
𣪊	殼
𣪎	愨
𣴷	挲
𤄝	灩
𤅿	灩
𤟌	獎
𤱪	畫
𤲯	畫
𥍯	鐫
𧍞	鱷
𧰚	豔
𧰟	豔
𧿘	陞
𨁠	陞
𨽶	畫
