㐀	丘
㐅	五
㐫	凶
㐮	襄
㐯	庸
㐱	鬒
㐴	攀
㐵	儒
㑁	𠭴
㑄	侮
㑌	尩
㑝	𢙱
㒇	儛
㒋	廝 厮
㒚	穩
㒞	儶
㒰	全
㒲	財
㒷	興
㓁	网
㓮	彫 雕
㓷	劓
㓸	斲
㔍	䥷
㔱	斞
㔾	卩
㕑	𢊍 厨
㕚	爪 爫
㕞	刷
㗖	啖 噉 啗
㗳	嗒
㘅	銜 啣
㘽	栽
㙮	塔
㙳	轗
㚝	奞 奎
㚣	姣
㛛	娠
㝃	娩
㝛	宿
㝦	寯 𮱠
㝵	礙 碍
㝷	𡬶
㞐	居
㟗	邠 豳
㟢	埼 崎 嵜 碕 陭 﨑 𥔎
㠊	嶇
㠯	以
㠶	帆
㡅	𣍓
㡘	𢅏
㡿	斥
㢴	西
㣶	邅
㣺	心 忄
㣼	忍
㤒	笨
㤵	慈
㥃	悶 懣
㥵	慁
㦧	憯
㧃	收
㧖	扼 搤
㧜	擸
㨉	抿
㨗	捷
㨨	㩅
㨼	撂
㩁	搉
㩅	㨨
㩜	攬 擥
㩹	𢶣
㪅	更
㪯	舉
㫃	偃
㫎	幑 𣄈
㫚	昒
㬅	曼
㬱	朁
㬹	踭
㭒	耜
㭨	椰
㮣	槩 槪
㯃	漆 桼
㯭	樐 櫓
㯶	棕
㯽	檳
㰍	櫳
㱿	殼 壳
㲒	勽
㲓	毧
㳄	涎
㴑	溯
㴔	潝
㵒	沸
㷉	熨
㷠	燐 粦
㷻	煳
㽣	域
㽽	痼
㾙	脪
㿟	皦 皎
㿷	糙
䀋	鹽
䀠	瞿
䀡	䦓 覘
䀢	瞬
䀹	睫
䂀	𥋟
䂫	夯
䃉	珉
䃘	硜
䄃	殃
䄍	蜡
䄯	𢆞
䄺	稊
䆋	秋
䆔	竉
䆫	窓 窗
䆼	窠
䈇	罩
䉵	饌 籑
䊜	糰
䋲	繩
䌥	縯
䌫	纜
䏕	飪
䐰	饈
䒒	苕
䔛	檾
䕌	稚
䕭	蕁
䖈	虐
䖍	虔
䖏	処 處
䖟	蝱
䖣	蚤
䖵	蜫
䗦	䗬
䗬	䗦
䘑	脉
䘚	卒
䘺	綻
䙝	褻 褺
䚎	𥅾
䛡	話
䛻	誘
䛼	譭
䜊	嘈
䜶	豇
䝋	豵
䝜	狻
䝤	獠
䞓	赬
䠊	剕
䠱	躅
䢙	敗
䢜	歸
䣩	醇
䤍	𨢥
䤠	鍺
䥀	捵
䥨	鑢
䥪	𮸗
䥷	㔍
䦓	䀡 覘
䨘	霰
䨶	𩆆
䩞	韂
䪊	龓
䪿	囟
䬒	颼
䬡	翥
䭾	馱
䯌	尻
䯻	髻
䰗	鬮
䰞	煮
䱇	鱓
䱷	漁
䱽	鯧
䳘	鵝
䴸	麩
䴹	餜
䵑	䵒
䵒	䵑
䶏	涕
一	弌 壹
七	柒
万	卍 萬
三	叁
与	與
丐	匃
丘	㐀 坵
东	東
丟	丢
両	兩 两
丢	丟
两	両 兩
並	幷 并 竝
个	個 箇
乃	迺 廼
么	幺
义	義
乔	喬
乚	隱
九	玖
乱	亂
乹	乾
乾	乹 亁
亁	乾
亂	乱
予	余
争	爭
亊	事
事	亊
二	弍 貳
于	扵 於
亏	於 扵
五	㐅
亗	岁 歲 𡻕
亝	齊
亡	兦 亾
亲	榛
人	亻
亻	人
亼	集
亾	亡
仇	讎 讐
从	從
他	她 牠
仙	僊
仝	同
仟	千 阡
以	㠯
任	仼
仼	任
仾	低
仿	倣
伀	彸
伃	妤
会	會
伭	玄
伱	你
伷	冑 胄
佇	竚
佋	紹
低	仾
佑	祐
体	體 軆
佗	它
余	予
作	𠈨
你	伱
佰	百
併	𠊧
使	𠭆
侁	駪 詵
侂	託
侅	賅
來	来
侎	敉
侖	崙
侚	殉 狥
侣	侶
侮	㑄
侶	侣
俈	嚳
俓	徑
俞	兪
俟	竢
俯	頫
俻	備
倈	徠 勑
個	个 箇
倏	倐
倐	倏
倖	幸
倘	儻
倣	仿
値	值
倪	𮯴
值	値
偁	穪 稱
偃	㫃
偊	踽
偐	贋 贗
偒	蕩
健	徤
偪	逼
偵	遉
偷	偸
偸	偷
偺	昝 咱
傁	叟 叜
傌	罵
傏	搪
傑	杰
傘	繖
備	俻
傜	徭
傻	儍
傽	慞
僊	仙
僱	雇
儆	警
儍	傻
儒	㐵
儓	檯 枱
儛	㒇
儭	襯
儶	㒞
儻	倘
兌	兑
兎	兔
兑	兌
兔	兎
兦	亡
全	㒰
兩	両 两
兪	俞
八	捌
兮	𠔃
兹	玆 茲
冂	坰 冋
冄	冉
冉	冄
冋	冂 坰
冑	伷 胄
冒	冒
冗	冗 宂
冤	寃
冩	寫
冪	羃 鼏
冫	氷 冰
冰	冫 氷 𣲝
冱	沍 沪
冲	沖
决	決
况	況
凂	浼
凄	淒
准	準
凈	淨
凉	涼
减	減
凑	湊
凛	懔
凡	凢 凣
凢	凡
凣	凡
処	䖏 處
凳	櫈
凴	憑
凶	㐫
凹	𠕄
出	岀
函	凾 圅
凾	函 圅
刀	刂
刂	刀
刃	刄
刄	刃
刅	創
刊	刋
刋	刊
刓	园
刘	劉
删	刪
刦	刧 劫
刧	刦 劫
刨	鉋
利	𥝢
刪	删
刱	創
刴	剁
刷	㕞
刼	劫
剁	刴
剃	鬀
剋	尅
剕	䠊
剗	剷
剛	𠇝
剦	閹
剩	賸
剪	翦
剳	劄
創	刅 刱 戧
剷	剗
剿	𠞰
劄	剳
劈	擗
劉	刘
劍	劒
劎	劔
劒	劍
劓	㓷
劔	劎
劝	勸
办	辦
劫	刦 刧 刼
効	效
勄	敏
勅	勑 敕
勑	倈 勅 敕 徠
勖	勗
勗	勖
勛	勳
勰	協 恊
勳	勛
勸	劝
勹	包
勻	匀
勽	㲒 菢
匀	勻
匃	丐 匄
匄	匃
包	勹
匆	悤 怱
匈	胸 胷
匊	掬
匋	陶
匏	瓟
匘	腦
匙	鍉
匝	帀 迊 𠂝
匧	篋
匯	滙
匱	樻 鐀 櫃 饋
匳	奩
匵	櫝
匹	疋
医	醫
千	仟
卄	廿
卉	芔
卌	𠦌
卍	万 卐 萬
卐	卍
卒	䘚
協	勰 旪
单	單
博	愽
卧	臥
卩	㔾
卬	卭
卭	卬
卯	戼
危	𡴲 𡵁
即	卽
却	卻
卹	恤
卻	却
卽	即
厄	戹
历	厲
厎	砥
厓	崖
厖	庬
厘	釐 𭀖
原	𠪥
厠	廁
厤	曆
厦	廈
厨	㕑 廚 𢊍
厩	廐
厪	廑
厮	㒋 廝
厰	廠
厲	历
厶	某
厷	肱
厹	叴
叁	三
參	叅
叅	參
双	雙
収	收
叔	尗
变	變
叙	敍 敘
叜	傁 叟
叟	傁 叜
叠	曡 疊
叡	睿
叢	樷
叨	饕
只	子
叫	呌
台	臺
叴	厹
叵	尀
号	號
吃	喫
吊	弔
同	仝
吒	咤
吚	咿
吝	恡 悋
吞	呑
吟	唫
吣	唚
吨	啍
听	聽
吲	哂
吳	呉
吶	訥
吸	噏
吹	龡
吻	呡 肳
吿	告
呆	獃
呉	吳
告	吿
呌	叫
呑	吞
呠	歕 噴
呡	吻
周	週
呪	詋 咒
咀	觜 嘴
咂	𠯗
咊	和 龢
和	咊 龢
咏	詠
咒	呪
咤	吒
咨	嗞 諮
咩	哶
咬	齩
咱	偺
咲	笑
咳	欬
咷	啕
咽	嚥
咿	吚
哂	吲
响	響
哦	誐
哲	喆 悊
哴	喨
哶	咩
唁	喭
唇	脣
唉	欸
唊	硤
唚	吣
唫	吟
唬	諕 猇 虓
唾	涶
啃	齦
啍	吨
啎	忤
啓	啟
啕	咷
啖	㗖 噉 啗
啗	㗖 啖 噉
啜	欼 諁 歠
啞	瘂
啟	啓
啣	㘅
啼	嗁
喂	餧
喃	諵
喆	哲
喐	郁
喒	昝
喜	憙
喧	諠
喨	哴
喫	吃
喬	乔
喭	唁
單	单
喿	噪
嗁	啼
嗅	齅
嗉	膆
嗒	㗳
嗞	咨 諮
嗥	嚎 嘷
嗽	瘶
嘆	歎
嘈	䜊
嘍	謱
嘗	甞
嘩	譁
嘯	歗
嘱	囑
嘴	咀 觜
嘷	嗥
嘿	默
噂	譐
噉	㗖 啖 啗
噏	吸
噐	器
噑	嚎
噦	𧬨
器	噐
噪	喿 譟
噴	呠 歕
嚎	嗥 噑
嚥	咽
嚬	顰
嚳	俈
嚵	饞
嚹	𡅈
囁	讘
囈	讛
囑	嘱
囓	齧
囘	囬 回
四	肆
回	囘 廻 囬
囟	䪿 顖
囤	𥫱
囪	囱
囬	囘 回
园	刓
囮	𡈙
囯	國
困	睏
囱	囪
圅	函 凾
國	囯
圕	圖
圖	圕
圝	圞
圞	圝
圢	町
圣	聖
圩	墟
圬	杇
圭	珪
坆	墳
坋	坌
坌	坋
坎	埳
坏	坯
坑	阬
坛	壇
坟	墳
坤	堃
坭	泥
坯	坏
坰	冂 冋
坵	丘
垔	陻 堙
垛	垜
垜	垛
垻	壩
埇	甬
埜	野
域	㽣
埳	坎
埶	蓺 秇 藝
執	执
埼	㟢 崎 嵜 碕 陭 﨑 𥔎
埽	掃
堃	坤
堇	菫
堈	缸 罁
堘	塍
堙	垔 陻
堤	隄
堦	階
堭	隍
報	报
場	塲
堿	鹼 鹻
塍	堘
塐	塑
塑	塐
塔	㙮 墖
塟	葬
塡	窴
塢	隝 隖 鄔
塤	壎
塩	鹽
塲	場
塹	壍
塼	磚
墈	磡
墖	塔
墝	磽
墟	圩
墤	隤
墫	樽 罇
墰	罈 壜
墳	坆 坟
墻	廧 牆
壇	坛
壍	塹
壎	塤
壐	璽
壜	墰 罈
壩	垻
声	聲
壳	㱿 殻
壹	一 弌
壻	婿
壽	寿 夀
夀	壽 寿
夅	降
変	變
够	彀 夠
夠	够 彀
夢	梦 夣
夣	夢
天	靝
夯	䂫
夸	誇
奇	竒
奈	柰
奎	㚝 奞
奔	犇
奕	弈
奞	㚝 奎
奩	匳
奶	妳 嬭
她	他
妊	姙
妒	妬
妙	玅
妝	粧
妤	伃
妬	妒
妳	奶 嬭
姆	姥
姉	姊
姊	姉
姍	姗
姗	姍
姙	妊
姣	㚣
姥	姆
姻	婣
娘	孃
娠	㛛
娩	㝃
娬	嫵
娿	婀
婀	娿
婣	姻
婦	媍
婬	淫
婿	壻
媆	嫩
媍	婦
媿	愧
嫉	𡜱
嫕	嫛
嫛	嫕
嫩	媆 𡞾
嫫	嬷
嫵	娬
嫺	嫻
嫻	嫺
嬌	撟
嬪	𡴓
嬭	奶 妳
嬰	孾
嬷	嫫
孀	霜
孃	娘
子	只
孭	𧴯
學	斈
孼	孽
孽	孼
孾	嬰
宂	冗
它	佗 牠
完	烟 煙
宐	宜
宜	宐
宝	寚 寳 寶
宴	讌
宻	密
宼	寇
宿	㝛
寃	冤
密	宻
寇	宼
寍	寧
寔	實
寕	寜
寗	甯
寘	置
寚	宝 寳
寜	寕
察	詧
寠	窶
寡	關
實	寔
寧	寍 𡨴
寨	砦
寫	冩
寯	㝦 𮱠
寳	宝 寚 寶
寵	𠖥
寶	宝 寳
对	對
寿	壽 夀
尀	叵
尃	旉 敷
尅	剋
将	𤕭
將	𤕭
專	耑 𡵏
對	对
尒	尔 爾
尔	尒 爾
尗	叔
尢	尣
尣	尢
尨	狵
尩	㑌
尰	腫
尲	尷
尷	尲
尸	屍
尻	䯌
尽	盡
居	㞐
屆	届
屉	屜
届	屆
屍	尸
屜	屉 𡲕
属	𡱆 屬
屣	蹝 躧
屬	属 𡱆
岀	出
岁	亗 歲 𡻕
岡	崗
岨	砠
岩	巖
峒	洞
峨	峩
峩	峨
峭	陗
峯	峰
峰	峯
崎	㟢 埼 嵜 碕 陭 﨑 𥔎
崒	崪
崔	磪
崖	厓
崗	岡
崘	崙
崙	侖 崘
崧	嵩
崪	崒
嵗	歲
嵜	㟢 埼 崎 碕 陭 﨑 𥔎
嵠	谿
嵩	崧
嶃	磛
嶄	巉
嶇	㠊
嶎	蔚
嶝	磴
嶩	旳
巉	嶄
巍	魏
巖	岩
巛	川
川	巛
巡	廵
巤	鬣
帀	匝 迊
帆	㠶 颿
帋	紙
帒	袋
帙	袠
帚	箒
帬	裙
帮	幫 幇
帳	賬
幂	鼏
幇	帮 幫
幑	㫎
幕	幙
幙	幕
幞	襮
幟	旘
幡	旛
幫	帮 幇
幵	开
并	並 幷 竝
幷	並 并 竝
幸	倖
幺	么
庄	莊
庅	麽 麼
床	牀
庙	廟
庬	厖
庵	菴
庸	㐯 𠆌
庾	斞
廀	廋
廁	厠
廈	厦
廋	廀
廌	豸
廐	厩
廑	厪
廔	樓
廕	蔭
廚	厨
廝	㒋 厮
廟	庙
廠	厰
廧	墻 牆
廱	雝
廵	巡
廸	迪
廹	迫
廻	回 迴
廼	乃 迺
廿	卄
开	幵
弈	奕
弊	𡚁
弋	𢍺
弌	一 壹
弍	二 貳
弔	吊
弢	韜
弦	絃
強	强 彊
强	強 彊
彀	够 夠
彊	強 强
彐	彑
彑	彐
归	歸
彫	㓮 雕
彬	斌
彷	髣 徬
彸	伀
往	徃
徃	往
徑	俓
徒	𨑒
從	从
徠	倈 勑
御	馭
徤	健
徧	遍
徬	彷
徭	傜
德	悳 惪
徹	澈
心	㣺 忄
忄	㣺 心
忍	㣼
忤	啎 迕
忭	昪
忻	欣
忼	慷
怀	懷
怌	懷
怨	𠨝
怪	恠
怱	匆 悤
怳	恍
恆	恒
恊	勰
恋	戀
恍	怳
恐	𢙢
恒	恆
恠	怪
恡	吝 悋
恤	卹
恥	耻
恩	摁
恿	慂
悁	懁
悅	悦
悊	哲
悋	吝 恡
悐	惕
悚	𢥠
悞	誤
悠	滺
悤	匆 怱
悦	悅
悳	德
悶	㥃 懣
惇	敦
惕	悐
惛	惽
惝	𢠵
惧	懼
惩	懲
惪	德
惺	𢜫
惽	惛
愈	愉
愉	愈
愍	憫
愠	慍
愧	媿
愬	訴
愻	遜
愽	博
愿	願
慁	㥵
慂	恿
慈	㤵
慍	愠
慙	慚
慚	慙
慞	傽
慷	忼
慼	慽
慽	慼
慾	欲
憇	憩
憋	𢠳
憑	凴 𠗦
憔	顦
憙	喜
憝	譈 懟
憩	憇
憫	愍
憯	㦧
憰	譎
懁	悁
懔	凛
懜	懵
懟	憝 譈
懣	㥃 悶
懥	懫
懫	懥
懲	惩
懵	懜
懷	怀 怌
懼	惧
懽	歡 欢
戀	𤕈
戉	鉞
戧	創
戯	戲
戱	戲
戲	戯 戱
戹	厄
戼	卯
扅	扊
扊	扅
手	扌
扌	手
扎	紮
扑	撲
托	拓
扞	捍
执	執
扯	撦
扳	攀
扵	于 亏 於
扼	㧖 搤
抌	舀
抍	拯
抝	拗
报	報
抬	擡
抽	𢭆
抿	㨉
担	擔
拇	𧿹
拏	拿 挐
拓	托
拕	拖
拖	拕
拗	抝
拭	𢂑
拯	抍
拼	摒
拿	拏 挐
挂	掛
挐	拏 拿
挫	繲
挭	骾 鯁
挱	挲
挲	挱
挷	搒
挼	捼
捆	綑
捌	八
捍	扞
捏	揑
捓	揶
捦	擒
捬	撫
捵	䥀
捶	箠
捷	㨗
捼	挼
掂	敁
掃	埽
掏	搯
掐	𠜼
掛	挂
掩	揜
掬	匊
掽	碰
揅	研
揑	捏
揜	掩
揝	撍
揦	攋
揪	揫
揫	揪
揶	捓
揸	楂 摣
搃	總 摠
搇	撳
搉	㩁
搒	挷
搖	摇
搗	擣
搜	𢯱 𢲷
搞	攪
搤	㧖 扼
搪	傏
搫	搬
搬	搫
搭	撘
搯	掏
携	攜
摁	恩
摇	搖
摒	拼
摠	搃 𢰾 總
摡	溉
摣	揸
摮	𢳆
撂	㨼
撆	撇
撇	撆
撍	揝
撐	撑
撑	撐
撘	搭
撟	嬌
撦	扯
撫	捬 𨑟
撲	扑
撳	搇
撽	擊
擃	攮
擄	虜
擊	撽
擋	攩 𫽮
擒	捦
擔	担
擗	劈
擡	抬
擣	搗
擥	㩜 攬
擧	舉
擲	擿
擸	㧜
擿	擲
攀	㐴 扳
攅	攢
攋	揦
攜	携
攢	攅
攩	擋 𫽮
攪	搞
攬	㩜 擥
攮	擃
攴	攵
攵	攴
收	㧃 収
攷	考
敁	掂
敃	暋
效	効
敉	侎
敍	叙 敘
敎	教
敏	勄
敕	勅 勑
敗	䢙
敘	叙 敍
教	敎
敠	敪
敦	惇 𠊋
敪	敠
敷	尃 旉
敺	驅
斁	𤢕
斅	斆
斆	斅 鏰
斈	學
斉	齊
斋	齋
斌	彬
斚	斝
斝	斚
斞	㔱 庾
斤	觔
斥	㡿
断	斷
斲	㓸 斵
斵	斲
斷	断
於	于 亏 扵
斾	旆
旂	旗
旆	斾
旈	旒
旉	尃 敷
旒	旈
旗	旂
旘	幟
旛	幡
无	無
旧	舊
旪	協
旳	嶩
时	時 旹
旹	时 時
昂	昻
明	朙
昏	昬
昒	㫚
昝	偺 喒
映	暎
昪	忭
昬	昏
昵	暱
昷	𥁕
昻	昂
晁	朝
時	时 旹
晅	烜
晉	晋
晋	晉
晒	曬
晡	𣇀
晰	晳
晳	晰
暋	敃
暎	映
暖	煖
暠	皜 𣉞
暱	昵
暴	虣
曆	厤 歴 歷
曖	瞹
曜	燿 耀 𮲝
曡	叠 疊
曬	晒
更	㪅
曼	㬅
朁	㬱
會	会
朐	鸜 鴝
朙	明
望	朢
朝	晁
朞	稘
朢	望
朳	杷
朴	樸
朵	朶
朶	朵
机	機
朿	莿
杇	圬
村	邨
杝	柂
杠	槓
条	條
来	來
杧	芒
杯	盃
杰	傑
東	东
杷	朳
杸	殳
板	版
枏	楠
果	菓
枬	楠
枱	儓 檯
架	榢
枾	柹
柁	舵
柂	杝
柄	棅
柏	栢
某	厶
柒	七
柚	櫾
柜	櫃
查	査
柰	奈
柳	栁 檉
柹	枾
査	查
栁	柳
标	檁
栒	簨
栖	棲
栛	荔
栢	柏
栰	筏
栽	㘽
桌	棹
桼	㯃 漆
梁	樑
梅	槑
條	条 糶
梟	鴞
梦	夢
梨	棃
梲	棳
梹	檳
棃	梨
棅	柄
棊	碁 棋
棋	棊 碁
棐	榧
棑	篺
棕	㯶 椶
棥	樊
棰	槌
棱	稜 楞
棲	栖
棳	梲
棹	桌 櫂
椀	盌 碗
椁	槨
椎	槌
椰	㭨
椶	棕
椹	葚
楂	揸 槎
楞	棱 稜
楠	枏 枬
楥	楦
楦	楥
楫	艥 檝
概	槩
榎	檟
榛	亲
榢	架
榧	棐
榨	醡
榮	荣
榴	橊
槀	稿
槊	鎙
槌	棰 椎
槎	楂
槑	梅
槓	杠 篢
槖	橐
槨	椁
槩	㮣 概
槪	㮣
槹	𣓌
樊	棥
樐	㯭 艪 櫓
樑	梁
樓	廔
樚	轆
樷	叢
樸	朴
樻	匱 櫃
樽	墫 罇
橆	無
橇	鞽
橊	榴
橐	槖
橓	蕣
橛	橜
橜	橛
機	机
檁	标
檉	柳
檐	簷
檔	欓
檛	簻
檝	楫 艥
檟	榎
檠	𢐧
檣	艢
檯	儓 枱
檳	㯽 梹
檴	穫
檾	䔛
櫂	棹
櫃	匱 柜 樻 饋 鐀
櫈	凳
櫌	耰
櫓	㯭 樐 艪
櫝	匵
櫱	蘖
櫳	㰍
櫺	欞
櫾	柚
欓	檔
欝	鬱
欞	櫺
欢	懽 歡
欣	忻
欬	咳
欲	慾
欵	款
欶	𠲿
欸	唉
欹	猗
欼	啜 歠
款	欵
歌	謌
歎	嘆
歕	呠 噴
歗	嘯
歠	啜 欼
歡	懽 欢
歱	踵
歲	亗 岁 嵗 歳 𡻕
歳	歲
歴	曆 歷
歷	曆 歴
歸	䢜 归
歹	歺
歺	歹
歿	殁
殁	歿
殂	𣨐
殃	䄃
殉	侚 狥
殰	𦢌
殳	杸
殺	𢿹
殻	壳
殼	㱿
殽	淆
毓	育
毗	毘
毘	毗
毡	氈
毧	㲓
氅	鷩
氈	毡 氊
氊	氈
氓	甿
氙	氥
氜	陽 阳
氡	氭
氣	炁
氤	絪
氥	氙
氭	氡
氯	綠
水	氵
氵	水
氷	冫 冰
氼	溺
汎	泛
汙	污 洿 汚
汚	汙 洿
污	汙
決	决
沈	沉
沉	沈
沍	冱
沒	𣇶
沖	冲
沪	冱
沱	沲
沲	沱
沸	㵒
況	况 𡶢
泄	洩 渫
泉	洤
泛	汎
泝	遡
泥	坭
泪	淚
洒	灑
洞	峒
洤	泉
洩	泄 渫
洿	汙 汚
浚	濬
浣	澣
浼	凂 潣
涅	湼
涌	湧
涎	㳄
涕	䶏
涖	莅 蒞
涶	唾
涼	凉 鿌
淆	殽
淒	凄
淚	泪
淜	漰
淡	澹
淨	凈
淫	婬
深	𣸧
淳	湻
淹	渰
渚	陼
減	减
渨	隈
温	溫
渫	泄 洩
渰	淹
渹	𢕐 𥔀 訇
湊	凑
湌	餐
湏	須
湧	涌
湻	淳
湼	涅
溉	摡
準	准
溫	温
溯	㴑 遡
溺	氼
溻	褟
溼	濕
溽	縟
滅	烕
滙	匯
滺	悠
漁	䱷
漆	㯃 桼
漇	𢳜
漎	潨
漫	澷
漰	淜
漾	瀁
漿	𤕯
潛	潜
潜	潛
潝	㴔
潣	浼
潨	漎
潬	灘
潸	𣽽
澀	澁 濇 瀒
澁	澀 濇
澈	徹
澗	磵
澣	浣
澳	襖 𥜌
澷	漫
澹	淡
濇	澀 澁 瀒
濕	溼
濛	霥 靀
濬	浚
濱	濵 瀕
濵	濱 瀕
濶	闊
濿	砅
瀁	漾
瀒	澀 濇
瀕	濱 濵
灑	洒
灘	潬
火	灬
灬	火
灯	燈
灰	灰
灴	烘
灵	靈
灶	竈
災	灾 烖 菑
灾	災 菑 烖
炁	氣
炉	爐
炤	照
炮	砲 炰 礮
炯	烱
炰	炮
炸	煠
点	點
為	爲
烊	煬
烕	滅
烖	災 灾 菑
烘	灴
烛	燭
烜	晅
烝	蒸
烟	完 菸 煙
烱	炯
焊	釬
無	无 橆
焧	熜 𮳳
焰	燄
煅	鍛
煆	鍜
煇	輝
煑	煮
煖	暖
煙	完 烟 菸
煠	炸
照	炤
煬	烊
煮	煑 䰞
煳	㷻
熇	燺
熈	熙
熏	燻 𤑕
熔	鎔
熙	熈
熜	焧 𮳳
熠	𮳜
熨	㷉
熱	𤍠
燄	焰
燈	灯
燐	㷠 粦
燒	簫
燭	烛
燺	熇
燻	熏
燿	曜 耀
爐	炉
爪	㕚 爫
爫	㕚 爪
爭	争
爲	為
爾	尒 尔
爿	𤕪
牀	床
牄	蹌
牆	墻 廧
版	板
牋	箋
牕	窻 窗 窓
牛	牜
牜	牛
牟	麰
牠	他 它
牴	觝
犁	犂
犂	犁
犇	奔
犬	犭
犭	犬
犲	豺
犴	豻
犹	猶
狥	侚 殉
独	獨
狵	尨
狷	獧
狸	貍
狹	陜
狻	䝜
猇	唬 虓
猋	飇 颮
猗	欹
猨	蝯 猿
猪	豬
猫	貓
猬	蝟
献	獻
猶	犹
猿	猨 蝯
獃	呆
獐	麞
獠	䝤
獧	狷
獨	独
獫	玁
獲	𫉬
獵	𤢪
獻	献
獾	貛
玁	獫
玄	伭
玅	妙
玆	兹 茲
玖	九
玟	玫
玫	玟
玳	瑇
珉	䃉 砇
珍	珎
珎	珍
珪	圭
珷	碔
琄	鞙
琅	瑯
琉	瑠 璢
瑇	玳
瑙	碯
瑠	琉
瑯	琅
璁	𤥼 𤦏 𤧚 𮴨
璃	瓈
璇	璿
璢	琉
璽	壐
璿	璇 𤩡
瓈	璃
瓟	匏
瓮	罋 甕
瓶	缾
瓷	甆 磁
甆	瓷
甎	磚
甕	瓮 罋
甖	罌 罃
甗	𮴼
甞	嘗
甤	蕤
甦	穌
甬	埇
甯	寗
町	圢
画	畫
甽	畎
甾	菑
甿	氓
畄	留 畱
畆	畝
畊	耕
畎	甽
留	畄 畱
畝	畆 𤱈
略	畧
畧	略
畫	画 畵
畱	畄 留
畵	畫
畺	疆
畽	疃
疃	畽
疆	畺
疊	叠 曡
疋	匹
疍	蛋
疎	疏
疏	疎
疣	肬
疱	皰
疴	痾
疸	癉
疹	胗
痄	𤶙
痐	蚘
痒	癢
痮	脹
痴	癡
痹	痺
痺	痹
痼	㽽
痾	疴
瘂	啞
瘉	癒
瘨	癲
瘶	嗽
瘺	瘻
瘻	瘺
癉	疸
癒	瘉
癡	痴
癢	痒
癯	臞
癲	瘨
登	豋
百	佰
皁	皂
皂	皁
皃	貎 貌
的	旳
皋	臯 睾
皎	㿟 皦
皓	顥 皝
皜	暠
皝	皓 顥
皞	皡 皥
皡	皞 皥
皥	皞 皡
皦	㿟 皎
皰	疱
皷	鼔 鼓
皺	縐
盃	杯
盇	盍
益	益
盌	椀 碗
盍	盇
盖	蓋 葢
盗	盜
盙	簠
盜	𠪁
盞	醆
盡	尽
盩	盭
盪	蕩 蘯
盭	盩
眇	緲
眈	躭
眎	視
眞	真
真	眞
眥	眦
眦	眥
眾	衆 𠂝
着	著
睏	困
睫	䀹
睹	覩
睾	皋
睿	叡
瞅	矁 𬑡
瞍	𥈟
瞠	瞪
瞥	苤
瞪	瞠
瞬	䀢
瞯	瞷
瞰	矙
瞷	瞯
瞹	曖
瞿	䀠
矁	瞅 𬑡
矋	矖
矖	矋
矙	瞰
矧	訠
矮	躷
石	𥐘
砅	濿
砇	珉
砌	纖
砒	磇
研	揅
砠	岨
砣	𥓿 鉈
砥	厎
砦	寨
砧	碪
砲	炮 礮
硜	䃘 踁
硤	唊
硭	𥐞
碁	棊 棋
碍	㝵 礙
碔	珷
碕	㟢 埼 崎 嵜 陭 﨑 𥔎
碗	椀 盌
碪	砧
碯	瑙 𮵑
碰	掽
碱	鹼 鹻
磁	瓷
磇	砒
磊	磥
磌	𧰊
磒	隕
磚	塼 甎
磛	嶃
磡	墈
磥	磊
磪	崔
磴	嶝
磵	澗
磽	墝
礙	㝵 碍
礟	礮
礦	鑛
礮	炮 砲 礟
礱	𤮨
礶	罐
示	礻
礻	示
礼	礼 禮
礿	禴
祐	佑
祕	秘
禀	稟
禂	禱
禮	礼 礼
禱	禂
禴	礿
禿	秃
秃	禿
秄	耔
秆	稈
秇	埶 蓺 藝
秈	籼
秋	䆋 秌 龝
秌	秋
秏	耗
秐	耘
秔	粳 稉
秕	粃
秘	祕
秸	稭
移	迻
稈	秆
稉	秔 粳
稊	䄺
稘	朞
稚	䕌 穉 稺
稜	棱 楞
稟	禀
稬	糯
稭	秸
稱	偁 穪
稺	稚
稾	稿
稿	槀 稾
穀	糓
穅	糠
穆	𥟟
穉	稚
穌	甦
穎	頴
穤	糯
穩	㒚
穪	偁 稱
穫	檴
穽	阱
窃	竊
窌	窖
窓	䆫 牕 窗 窻
窖	窌
窗	䆫 牕 窓 窻
窠	䆼
窮	竆
窯	窰
窰	窯
窴	塡
窶	寠
窻	牕 窓 窗
竆	窮
竈	灶
竉	䆔 𥥅
竊	窃
竒	奇
竚	佇
竝	並 并 幷
竢	俟
竦	𢖗
竪	豎
競	誩
竻	簕 𥵚
竿	𣔼
笋	筍
笑	咲
笓	篦
笔	筆
笛	篴
笨	㤒
筆	笔
筍	笋
筏	栰
答	荅
筦	管
筭	算
筯	箸
筱	篠
箇	个 個
箋	牋
箍	箛
箎	篪
箒	帚
箖	籃
算	筭
箛	箍
箠	捶
管	筦
箴	針 鍼
箸	筯
箾	簫
篋	匧
篠	筱
篡	簒
篢	槓
篦	笓
篩	簛 簁
篪	箎
篴	笛
篺	棑
簁	篩 簛
簋	𣪕 𣪘
簌	雝
簒	篡
簕	竻
簛	篩 簁
簠	盙
簡	耕
簣	蕢 籄
簨	栒
簫	燒 箾
簷	檐
簻	檛
簾	𢅖 𢅏
籃	箖
籄	簣 蕢
籐	藤
籑	䉵 饌
籥	龠
籲	龥
籼	秈
粃	秕
粗	麤 麄 觕
粘	黏
粤	粵
粦	㷠 燐
粧	妝
粮	糧
粳	秔 稉
粵	粤
粽	糉
糇	餱
糉	粽
糍	餈
糓	穀
糕	餻
糖	餹
糙	㿷
糟	醩
糠	穅
糡	糨
糤	饊
糧	粮
糨	糡
糯	稬 穤 𥻟
糰	䊜
糶	條
糸	糹
糹	糸
糺	糾
糾	糺
紙	帋
級	𨸚
紟	衿
紥	紮
紬	綢
紮	扎 紥
紲	緤
紹	佋
絃	弦
絅	褧
絖	纊
絚	緪 縆
絛	縚
絝	袴 褲
絥	鞴
絪	氤
統	綂
綂	統
綉	繡
綑	捆
經	𦀇
綠	氯
綢	紬
綫	線
綳	繃
綻	䘺
綿	緜
緊	𦂳
線	綫
緜	綿
緣	縁
緤	紲
緥	褓
緪	絚 縆
緫	總
緲	眇
縁	緣
縂	總
縆	絚 緪
縐	皺
縚	絛
縟	溽
縧	𮶃
縭	褵
縯	䌥
總	搃 𢰾 摠 緫 縂
繃	綳
繅	繰
繈	繦 襁
繖	傘
繞	遶
繡	綉
繦	繈 襁
繩	䋲
繮	韁
繰	繅
繲	挫
纊	絖
纎	纖
纖	砌 纎
纜	䌫
绦	𮶃
缶	缻
缸	堈 罁
缻	缶
缽	鉢
缾	瓶
罁	堈 缸
罃	甖 罌
罅	𨻲
罇	墫 樽
罈	墰 壜
罋	瓮 甕
罌	甖 罃
罐	礶
网	𦉽
罔	网
罗	羅
罩	䈇
罪	辠
置	寘
罵	傌
羃	冪
羅	罗
羇	覉
羈	覊
羌	羗
美	羙
羓	豝
羖	𦍩
羗	羌
羙	美
羡	羨
羣	群
群	羣
羨	羡
義	义
羮	羹
羴	羶
羶	羴
羹	羮
翄	翅
翅	翄
翥	䬡
翦	剪
翱	翺
翺	翱
翻	飜
耀	曜 燿
考	攷
耏	耐
耐	耏
耑	專
耔	秄
耕	畊 簡
耗	秏
耘	秐
耙	鈀
耜	㭒
耤	藉
耨	鎒
耰	櫌
耻	恥
耼	聃
聃	耼
聖	圣
聝	馘
聦	聰
聰	聦
聲	声
職	軄
聻	魙
聽	听
肆	四
肇	肈
肈	肇
肎	肯
肐	胳 𩨘
肕	韌
股	𦙶
肢	胑
肧	胚
肨	胮
肬	疣
肯	肎
肱	厷
育	毓
肳	吻
肴	餚
胄	伷 冑
胆	膽
胑	肢
胓	𦚓
胔	骴
胗	疹
胚	肧
胭	臙
胮	肨
胯	骻
胳	肐 𩨘
胷	匈 胸
胸	匈 胷
脃	脆
脅	脇
脆	脃
脇	脅
脈	衇 脉
脉	䘑 脈 衇
脚	腳
脣	唇
脪	㾙
脹	痮
脺	膵
腊	臈 臘
腕	𦙵
腢	髃
腦	匘
腫	尰
腭	齶
腮	顋
腳	脚
腸	膓
腿	骽
膆	嗉
膋	膫
膓	腸
膘	臕
膫	膋
膳	饍
膵	脺
膽	胆
膾	鱠
臇	𤎱
臈	腊 臘
臊	𦞣
臏	髕
臕	膘
臘	腊 臈
臙	胭
臝	裸
臞	癯
臥	卧
臯	皋 𦤎
臺	台
臿	鍤
舀	抌
舃	舄
舄	舃
與	与
興	㒷
舉	㪯 擧
舊	旧
舐	舓
舓	舐
舔	餂
舖	鋪
舘	館
舞	𦐀
舡	船
舦	艜
舰	𮶙
舵	柁
船	舡
艜	舦
艢	檣
艥	楫 檝
艦	𮶙
艪	樐 櫓
艶	豓 豔
艸	草 艹
艹	艸 草
芒	杧
芔	卉
芟	𠚹
芦	蘆
花	芲 蘤
芲	花
芻	蒭 𦷝
苕	䒒
苟	茍
苡	苢
苢	苡
苤	瞥
苺	莓
茍	苟
茜	蒨
茠	薅
茲	兹 玆
荅	答
荆	荊
荇	莕
草	艸 艹
荊	荆
荍	蕎
荐	薦
荔	栛
荣	榮
荳	豆
莀	農
莅	涖 蒞
莊	庄
莓	苺
莕	荇
莜	蓧
莺	𮹘
莿	朿
菇	菰 𦱄
菌	蕈
菑	災 灾 烖 甾
菓	果
菔	蔔
菢	勽
菫	堇
菰	菇
菴	庵
菸	烟 煙
萆	蓖
萬	万 卍
萱	萲 蕿 蘐
萲	萱
萼	蕚
葁	薑
著	着
葚	椹
葢	盖 蓋
葬	塟
葯	藥
葱	蔥
蒓	蓴
蒞	涖 莅 𦲷
蒨	茜
蒭	芻
蒸	烝
蓋	盖 葢
蓖	萆
蓧	莜
蓴	蒓
蓺	埶 秇 藝
蔔	菔
蔗	𧀹
蔚	嶎
蔥	葱
蔭	廕
蔴	麻
蔾	藜
蕁	䕭
蕈	菌
蕊	蕋 蘂
蕋	蕊
蕎	荍
蕚	萼
蕢	簣 籄
蕣	橓
蕤	甤
蕩	偒 盪 蘯
蕿	萱
薅	茠
薑	葁
薟	蘞
薦	荐
薯	藷
藇	𨣦
藉	耤
藜	蔾
藝	埶 秇 蓺
藟	蘽
藤	籐
藥	葯
藦	蘑
藷	薯
蘂	蕊
蘆	芦
蘐	萱
蘑	藦
蘖	櫱
蘞	薟
蘤	花
蘯	盪 蕩
蘽	藟
虐	䖈
虓	唬 猇
虔	䖍
處	䖏 処
虜	擄
虞	𩦢
號	号
虣	暴
虫	蟲
虬	蚪 虯
虯	虬
虱	蝨
蚊	蟁
蚋	蜹
蚌	蜯
蚓	螾
蚕	蠶
蚘	痐 蛔 蛕
蚝	螆
蚡	鼢
蚤	䖣
蚦	蚺
蚪	虬
蚺	蚦
蛄	蛌
蛆	𧐅
蛋	疍 蜑
蛌	蛄
蛓	螆
蛔	蚘 蛕
蛕	蚘 蛔
蛗	𧌓
蛙	鼃
蛛	鼄
蜂	蠭
蜇	𧋍
蜋	螂
蜍	蠩
蜑	蛋
蜝	蜞
蜞	蜝
蜡	䄍 蠟
蜨	蝶
蜫	䖵
蜯	蚌
蜶	蟀
蜹	蚋
蝃	螮
蝇	蠅
蝎	蠍
蝟	猬
蝡	蠕
蝥	蟊
蝦	鰕
蝨	虱
蝯	猨 猿
蝱	䖟
蝶	蜨
螂	蜋
螆	蚝 蛓
融	螎
螎	融
螗	螳
螘	蟻
螙	蠧
螮	蝃
螳	螗
螺	蠃
螾	蚓
蟀	蜶
蟁	蚊
蟊	蝥
蟚	蟛
蟛	蟚
蟮	蟺
蟲	虫
蟹	蠏
蟺	蟮
蟻	螘
蠃	螺
蠅	蝇
蠍	蝎
蠏	蟹
蠔	𧐢
蠕	蝡
蠟	蜡
蠧	螙
蠩	蜍
蠭	蜂
蠶	蚕
衂	衄
衄	衂
衅	釁
衆	眾 𬑔
衇	脈 脉
衛	衞
衝	𧘂
衞	衛
衣	衤
衤	衣
衮	袞
衽	袵
衿	紟 襟
袋	帒
袒	襢
袜	襪
袞	衮
袠	帙
袴	絝 褲
袵	衽
袷	裌
裉	褃
裌	袷
裏	裡
裙	帬 裠
裠	裙
裡	裏
裸	臝 躶
褃	裉
褎	褏
褏	褎
褒	襃
褓	緥
褟	溻
褢	褱
褧	絅
褱	褢
褲	絝 袴
褵	縭
褶	襵
褺	䙝 褻
褻	䙝 褺
襁	繈 繦
襃	褒
襄	㐮
襇	襉
襉	襇
襍	雜
襖	澳 𥜌
襜	襝
襝	襜
襟	衿
襢	袒
襪	袜 韤 韈
襮	幞
襯	儭
襵	褶
西	㢴 𠧧
覇	霸
覉	羇
覊	羈
覌	觀
覐	覺
覓	覔
覔	覓
視	眎
覘	䀡 䦓
覥	靦
覩	睹
覰	覷
覷	覰
覺	覐
觀	覌
觔	斤
觕	粗 麄 麤
觜	咀 嘴
觝	牴
解	觧
觥	觵
觧	解
觵	觥
言	訁
訁	言
訇	𢕐 渹 𥔀
訕	赸
託	侂
訛	譌
訠	矧
訥	吶
訦	諶
訩	詾
訴	愬
証	證
訽	詬
詋	呪
詠	咏
詤	謊
詧	察
詬	訽
話	䛡
詵	侁 駪
詾	訩
誇	夸
誐	哦
誕	𧩙
誘	䛻
誚	譙
誤	悞
誩	競
諁	啜
談	譚
諉	餵
諊	鞫
諕	唬
諠	喧
諡	謚
諤	讍
諧	龤
諮	咨 嗞
諵	喃
諶	訦
謊	詤
謌	歌
謚	諡
謫	讁
謱	嘍
譁	嘩
譈	憝 懟
證	証
譌	訛
譎	憰
譐	噂
譙	誚
譚	談
譟	噪
警	儆
譭	䛼
讁	謫
變	变 変
讌	宴
讍	諤
讎	仇 讐
讐	仇 讎
讘	囁
讛	囈
谿	嵠
豆	荳
豇	䜶
豋	登
豎	竪
豓	艶 豔
豔	艶 豓
豘	豚
豚	豘
豜	豣
豝	羓
豣	豜
豫	預
豬	猪
豳	㟗 邠
豴	蹢
豵	䝋
豸	廌
豺	犲
豻	犴
貌	皃
貍	狸
貎	皃
貓	猫
貛	獾
財	㒲
販	𧶶
貭	質
貯	𮷍
貳	二 弍
賅	侅
賍	贓 贜
賓	賔
賔	賓
賛	贊
賢	贒
質	貭
賫	齎
賬	帳
賮	贐
賴	頼
賷	齎
賸	剩
賺	贃
贃	賺 𧸖
贊	賛
贋	偐 贗
贐	賮
贒	賢
贓	賍 贜
贗	偐 贋
贜	賍 贓
贮	𮷍
赤	𤆍
赩	𦫜
赬	䞓
赶	趕
赸	訕
趁	趂
趂	趁
趄	跙
趋	趨
趑	趦
趒	跳
趕	赶
趦	趑
趨	趋
趮	躁
趯	躍
跖	蹠
跙	趄
跡	蹟 迹
跥	跺
跳	趒 𨁔
跴	踹
跺	跥
踁	硜
踊	踴
踏	蹋
踪	蹤
踭	㬹
踰	逾
踴	踊
踵	歱
踹	跴
踽	偊
蹄	蹏
蹋	踏 蹹
蹌	牄
蹏	蹄
蹝	屣 躧
蹟	跡 迹
蹠	跖
蹢	豴
蹤	踪
蹧	遭
蹮	躚
蹴	蹵
蹵	蹴
蹹	蹋
蹺	蹻
蹻	蹺
躁	趮
躅	䠱
躋	隮
躍	趯
躗	躛
躚	蹮
躛	躗
躧	屣 蹝
躬	躳
躭	眈
躱	躲
躲	躱
躳	躬
躶	裸
躷	矮
軄	職
軆	体
軛	軶
軟	輭
軰	輩
軶	軛
軺	𨍳
輒	輙
輙	輒
輝	煇
輩	軰
輭	軟
輵	轕
輿	轝
轄	鎋
轆	樚
轕	輵
轗	㙳
轝	輿
轟	𮷛
轰	𮷛
辞	辤 辭
辠	罪
辢	辣
辣	辢
辤	辞 辭
辦	办
辨	辯
辭	辞 辤
辯	辨
農	莀
辵	辶
辶	辵
边	邊
迁	遷
过	過
迊	匝 帀
迕	忤
还	還
这	這
迨	逮
迩	邇
迪	廸
迫	廹
迯	逃
迴	廻
迹	跡 蹟
迺	乃 廼
迻	移
逃	迯
逓	遞
逖	逷
這	这
逮	迨
週	周
逷	逖
逼	偪
逾	踰
遁	遯
遉	偵
遍	徧
過	过
遜	愻
遞	逓
遟	遲
遡	泝 溯
遭	蹧
遯	遁
遲	遟
遶	繞
遷	迁 𨙞
還	还
邅	㣶
邇	迩
邊	边
邕	雍 𪪝
邠	㟗 豳
邨	村
郁	喐
郄	郤
郤	郄
郰	鄹
郷	鄉
鄉	郷 鄕
鄔	塢
鄕	鄉
鄰	隣
鄹	郰
酔	醉
酖	鴆
酧	酬 醻
酬	酧 醻
醆	盞
醇	䣩
醉	酔
醊	餟
醡	榨
醩	糟
醫	医
醻	酧 酬
醾	醿
醿	醾
釁	衅
野	埜
釐	𭀖 厘
金	釒
釒	金
釜	鬴
針	箴 鍼
釬	焊 銲
鈀	耙
鈃	銒
鈆	鉛
鈎	鉤
鈞	銁
鉄	鐵 銕
鉆	鉗 鑽
鉈	砣 𥓿
鉋	刨
鉏	鋤
鉗	鉆
鉛	鈆
鉞	戉
鉢	缽
鉤	鈎
銁	鈞
銒	鈃
銕	鉄 鐵
銜	㘅
銲	釬
銹	鏥 鏽
鋑	鐫 鑴
鋤	鉏
鋪	舖
錘	鎚
錢	𫢊
鍉	匙
鍊	𮸀
鍛	煅
鍜	煆
鍤	臿
鍫	鍬
鍬	鍫
鍰	鐶
鍳	鑑 鑒
鍺	䤠
鍼	箴 針
鎋	轄
鎌	鐮
鎏	鏐
鎒	耨
鎔	熔
鎖	鏁 鎻
鎙	槊
鎚	錘
鎧	𮸛
鎻	鎖
鏁	鎖
鏐	鎏
鏢	鑣
鏥	銹 鏽
鏰	斆
鏽	銹 鏥
鏾	𠜎
鐀	匱 櫃
鐫	鋑 鑴
鐮	鎌
鐵	鉄 銕
鐶	鍰
鑑	鍳 鑒
鑒	鍳 鑑
鑚	鑽
鑛	礦
鑢	䥨
鑣	鏢
鑴	鋑 鐫
鑽	鉆 鑚
铠	𮸛
門	门
閆	閻
閙	鬧
関	闗 關 𨶹
閧	鬨
閹	剦
閻	閆
闊	濶
闗	関 關
關	寡 関 闗
闞	鬫
门	門
阜	阝
阝	阜
阡	仟
阧	陡
阨	阸
阬	坑
阱	穽
阳	氜 陽
阴	陰
阸	阨
陀	陁
陁	陀
降	夅
陗	峭
陜	狹
陡	阧
陣	𨸬
陭	㟢 埼 崎 嵜 碕 﨑 𥔎
陰	阴 隂
陵	𨻪
陶	匋
陻	垔 堙
陼	渚
陽	氜 阳 𣆄
隂	陰
隄	堤
隈	渨
隍	堭
階	堦
隐	隠
隕	磒
隖	塢
隙	𨻶
隝	塢
隠	隐
隣	鄰
隤	墤
隧	𡑞
隩	𡒃
隮	躋
隱	乚
隲	騭
隷	隸
隸	隷
隼	鶽 鵻
隽	雋
难	難
雁	鴈
集	亼
雇	僱
雋	隽
雍	邕 𪪝
雕	㓮 彫
雙	双
雛	鶵
雜	襍
雝	廱 簌 𪪝
雞	鷄 鳮
難	难
雱	霶
雷	𤴐 𩇓
霜	孀
霡	霢
霢	霡
霥	濛
霰	䨘
霶	雱
霸	覇
靀	濛
靈	灵
靝	天
靦	覥
靧	頮
靭	韌
靴	鞾
鞀	鼗 鞉
鞉	鞀 鼗
鞋	鞵 𩋘
鞌	鞍
鞍	鞌
鞘	韒
鞙	琄
鞟	鞹
鞦	鞧
鞧	鞦
鞫	諊
鞲	韝
鞴	絥
鞵	鞋
鞹	鞟
鞽	橇
鞾	靴
韁	繮
韂	䩞
韈	襪 韤
韌	肕 靭
韒	鞘
韜	弢
韝	鞲
韤	襪 韈
韭	韮
韮	韭
韵	韻
韻	韵
響	响
頂	𩠑
須	湏
頋	顧
預	豫
頟	額
頣	頤
頤	頣
頫	俯
頮	靧
頴	穎
頼	賴
顋	腮
額	頟
顕	顯
顖	囟
願	愿
類	𩔖 𩔗
顥	皓 皝
顦	憔
顧	頋 𮸹
顯	顕
顰	嚬
顱	髗
顾	𮸹
颮	猋 飇
颼	䬒
颿	帆
飃	飄
飄	飃
飆	飇 飈
飇	猋 颮 飆
飈	飆
飜	翻
食	飠
飠	食
飡	餐
飢	饑
飤	飼
飦	饘
飧	飱
飪	䏕
飫	饇
飱	飧
飼	飤
飾	餙
餂	舔
餅	餠
餈	糍
餉	饟
餐	湌 飡
餒	餧
餙	飾
餚	肴
餛	餫
餜	䴹
餟	醊
餠	餅
餧	喂 餒
館	舘
餫	餛
餱	糇
餵	諉
餹	糖
餻	糕
餽	饋
饇	飫
饈	䐰 𦟤
饊	糤
饋	匱 櫃 餽
饌	䉵 籑
饍	膳
饑	飢
饕	叨
饘	飦
饞	嚵
饟	餉
馘	聝
馚	馩
馩	馚
馭	御
馱	䭾
馿	驢
駁	駮
駛	𩢲
駝	駞
駞	駝
駢	騈
駦	騰
駪	侁 詵
駮	駁
騈	駢
騌	騣
騐	驗
騗	騙
騘	驄
騙	騗
騣	騌
騭	隲
騰	駦
騾	驘
驄	騘
驅	敺
驊	𦽊
驗	騐
驘	騾
驢	馿
骴	胔 𦙼
骻	胯
骽	腿
骾	挭 鯁
髃	腢
體	体
髕	臏
髗	顱
高	髙
髙	高
髠	髡
髡	髠
髣	彷
髤	髹
髩	鬢
髹	髤
髻	䯻
髼	鬅
鬀	剃
鬂	鬢
鬅	髼
鬒	㐱
鬓	𩯭
鬢	髩 鬂
鬣	巤
鬥	鬭 鬬 鬦 鬪
鬦	鬥
鬧	閙
鬨	閧
鬪	鬥 鬬
鬫	闞
鬬	鬥 鬪
鬭	鬥
鬮	䰗
鬱	欝
鬴	釜
鬽	魅
魅	鬽
魏	巍
魙	聻
魟	鰩
魦	鯊
魷	鰌
鮎	鯰
鮝	鯗
鮧	鯷
鮮	鱻
鯁	挭 骾
鯊	魦
鯗	鮝
鯧	䱽
鯰	鮎
鯷	鮧
鰉	鱑
鰌	魷 鰍
鰍	鰌
鰐	鱷
鰕	蝦
鰩	魟
鰲	鼇
鱉	鼈
鱑	鰉
鱓	䱇 鱔
鱔	鱓
鱠	膾
鱷	鰐
鱻	鮮
鳮	雞 鷄
鴃	鵙
鴆	酖
鴈	雁
鴉	鵶
鴝	朐 鸜
鴞	梟
鴳	鷃
鴺	鵜
鵙	鴃
鵜	鴺
鵝	䳘 鵞
鵞	鵝
鵶	鴉
鵻	隼
鶂	鶃
鶃	鶂
鶯	鸎 𮹘
鶵	雛
鶽	隼
鷃	鴳
鷄	雞 鳮
鷩	氅
鷿	鸊
鸊	鷿
鸎	鶯
鸜	朐 鴝
鹻	堿 碱 鹼
鹼	堿 碱 鹻
鹽	䀋 塩 𥂁
麄	粗 觕 麤
麇	麕
麐	麟
麕	麇
麞	獐
麟	麐
麤	粗 觕 麄
麩	䴸
麪	麵
麫	麵
麯	麴
麰	牟
麴	麯
麵	麪 麫
麻	蔴
麼	庅 麽
麽	庅 麼
黏	粘
默	嘿 黙
黙	默
點	点
鼃	蛙
鼄	蛛
鼇	鰲
鼈	鱉
鼎	𪔂
鼏	冪 幂
鼓	皷 鼔 𩉲
鼔	皷 鼓
鼗	鞀 鞉
鼢	蚡
齁	𪖙
齅	嗅
齊	亝 斉
齋	斋
齎	賫 賷
齦	啃
齧	囓
齩	咬
齶	腭
龍	龒 𠊋 𢅛
龎	龐
龐	龎
龒	龍
龓	䪊
龝	秋
龠	籥
龡	吹
龢	咊 和
龤	諧
龥	籲
龭	𮹆
鿌	涼
﨑	㟢 埼 崎 嵜 碕 陭 𥔎
益	益
礼	礼 禮
𠂝	匝 眾
𠂤	𣳨
𠆌	庸
𠇝	剛
𠈨	作
𠊋	敦
𠊧	併
𠒇	兒
𠔃	兮
𠕄	凹
𠖥	寵
𠗦	憑
𠚹	芟
𠜎	鏾
𠜼	掐
𠞰	剿
𠦌	卌
𠧧	西
𠨝	怨
𠪁	盜
𠪥	原
𠭆	使
𠭴	㑁
𠯗	咂
𠱓	𠼮
𠱘	𠸺
𠲿	欶
𠸺	𠱘
𠼮	𠱓
𡅈	嚹
𡈙	囮
𡑞	隧
𡒃	隩
𡚁	弊
𡜱	嫉
𡝏	嬪
𡞾	嫩
𡨴	寧
𡬶	㝷
𡱆	属 屬
𡲕	屜
𡴓	嬪
𡴲	危 𡵁
𡵁	危 𡴲
𡵏	專
𡶢	況
𡻕	亗 岁 歲
𢂑	拭
𢅏	㡘 簾
𢅖	簾
𢅛	龍
𢆞	䄯
𢊍	㕑 厨
𢍺	弋
𢐧	檠
𢕐	渹 訇
𢖗	竦
𢙢	恐
𢙱	㑝
𢜫	惺
𢠳	憋
𢠵	惝
𢥠	悚
𢭆	抽
𢯱	搜
𢰾	摠 總
𢲷	搜
𢳆	摮
𢳜	漇
𢶑	𢸣
𢶣	㩹
𢸣	𢶑
𢿹	殺
𣁚	𣁟
𣁟	𣁚
𣄈	㫎
𣆄	陽
𣇀	晡
𣇶	沒
𣉞	暠
𣍓	㡅
𣓌	槹
𣔼	竿
𣨐	殂
𣪕	簋
𣪘	簋
𣲝	冰
𣳨	𠂤
𣸧	深
𣽽	潸
𤆍	赤
𤍠	熱
𤎱	臇
𤑕	熏
𤒹	爗
𤕈	戀
𤕪	爿
𤕭	将 將
𤕯	漿
𤢕	斁
𤢪	獵
𤥼	璁 𮴨
𤦏	璁
𤧚	璁
𤩡	璿
𤮨	礱
𤱈	畝
𤴐	雷
𤶙	痄
𥁕	昷
𥂁	鹽
𥅾	䚎
𥈟	瞍
𥋟	䂀
𥐘	石
𥐞	硭
𥓿	砣 鉈
𥔀	渹 訇
𥔎	㟢 埼 崎 嵜 碕 陭 﨑
𥜌	澳 襖
𥝢	利
𥟟	穆
𥥅	竉
𥫱	囤
𥵚	竻
𥻟	糯
𦀇	經
𦂳	緊
𦉽	网
𦍩	羖
𦐀	舞
𦙵	腕
𦙶	股
𦙼	骴
𦚓	胓
𦞣	臊
𦟤	饈
𦢌	殰
𦤎	臯
𦫜	赩
𦱄	菇
𦲷	蒞
𦷝	芻
𦽊	驊
𧀹	蔗
𧋍	蜇
𧌓	蛗
𧐅	蛆
𧐢	蠔
𧘂	衝
𧙀	𧞪
𧞪	𧙀
𧩙	誕
𧬨	噦
𧰊	磌
𧴯	孭
𧶶	販
𧸖	贃
𧿹	拇
𨁔	跳
𨃞	𨃟
𨃟	𨃞
𨈚	𨉉
𨉉	𨈚
𨌄	𮷚
𨍳	軺
𨑒	徒
𨑟	撫
𨙞	遷
𨢥	䤍
𨣦	藇
𨬫	𮸢
𨶹	関
𨸚	級
𨸬	陣
𨻪	陵
𨻲	罅
𨻶	隙
𩆆	䨶
𩇓	雷
𩉲	鼓
𩋘	鞋
𩔖	類
𩔗	類
𩠑	頂
𩢲	駛
𩦢	虞
𩨘	肐 胳
𩯭	鬓
𪔂	鼎
𪖙	齁
𪣷	𮰥
𪪝	邕 雍 雝
𫉬	獲
𫔀	𮸀
𫢊	錢
𫫲	𫬛
𫬛	𫫲
𫽮	擋 攩
𬎟	𮴹
𬑔	衆
𬑡	瞅 矁
𬨋	𮷚
𭀖	𭀖 厘 釐
𮯴	倪
𮰥	𪣷
𮰫	𮰭
𮰭	𮰫
𮱠	㝦 寯
𮱣	尵
𮲝	曜
𮳜	熠
𮳳	焧 熜
𮴌	𮴹
𮴨	璁 𤥼
𮴹	𬎟 𮴌
𮴼	甗
𮵑	碯
𮶃	縧 绦
𮶙	舰 艦
𮷍	貯 贮
𮷚	𨌄 𬨋
𮷛	轟 轰
𮸀	鍊 𫔀
𮸗	䥪
𮸛	鎧 铠
𮸢	𨬫
𮸹	顧 顾
𮹆	龭
𮹘	莺 鶯
冗	冗
灰	灰
冒	冒
