㒚	文
㒷	興
㓟	披
㔾	卩
㛛	娠
㴑	溯
㷉	熨
䄍	蜡
䖏	處
一	壹
七	柒
三	叁
丕	仳
个	個
中	塚
丼	井
乾	亁
亁	乾
二	貳
五	伍
井	丼
仇	讎 讐
从	從
仙	僊
仟	千
仳	丕
份	分
伍	五
伷	胄
佔	占
你	妳 您 祢 袮
佬	姆
來	耒
俓	勁
個	个 箇
倖	囟
偎	渨 隈
偺	喒
傁	墰
傍	旁
僊	仙
儎	載
儡	酹
八	捌
六	陸
冣	最 聚
凈	淨
几	幾
処	處
分	份
划	劃
刺	莿
剉	銼
剌	巤
剙	創
剳	劄
創	剙
劃	划
劄	剳
劳	勞
勁	俓 徑
勅	勑 敕
勑	勅
勞	劳
勰	脅
匜	鉈
十	拾
千	仟
卌	𠦜
卓	棹
占	佔
卩	㔾 節
卯	夘
厨	𢊍
厶	某
叁	三
參	叅 薓
叅	參
叉	釵
双	雙
叟	墰
只	祇
号	號
吋	寸
含	唅
听	聽
呃	阨
呆	獃
呴	詬
和	龢
咥	嘻
咮	胄
咱	喒
咳	欬
咽	嚥
哼	苛
唅	含
唉	欸
唾	涶
啊	阿
喂	餧 餵
喒	偺 咱
嗻	處
嘔	慪
嘻	咥
嚥	咽
囓	齧
四	肆
囟	倖 幸 顖
囮	諤
坆	墳
坏	坯
坐	座
坭	泥
坯	坏
域	譽
基	抍 拯
堆	𠂤
場	塲
堵	鍺
塚	中
塲	場
塾	孰
墰	傁 叟 罈
墳	坆
壳	殼
壹	一
夅	降
外	舀
夗	夘
夘	夗 卯
奔	犇
奶	嬭
妳	你 您 祢 袮
姆	佬 姥
姥	姆
娠	㛛 暖 煖
媆	嫰
嫩	嫰
嫰	媆 𡞾 嫩
嬭	奶
嬲	惱
孛	柏 栢
孰	塾
它	牠
寠	窶
寸	吋
对	對
将	將
將	将 畺 疆 𤕭
尉	熨
對	对
尿	溺
崋	華
巤	剌 鬣
帆	拚
帚	箒
幸	囟
幾	几
座	坐
弄	瘧
弍	貳
強	彊
强	彊
彊	強 强
当	當
彫	鵰
往	徃
徃	往
徑	勁
從	从
御	馭
怸	悉
恋	戀
悉	怸
您	你 妳 祢 袮
惱	嬲
惺	醒
愈	瘉
愬	訴
愿	願
慪	嘔
憂	懮
應	硬
懮	憂
戀	恋
扁	艑
才	纔 財
托	拓
抍	基
折	翼 拃
披	㓟
抬	擡
拃	折
担	擔
拆	責
拈	敁
拓	托 摭
拚	帆
拯	基
拼	秉
拽	曳
拾	十
按	搵
挽	掇
捉	杓
捌	八
捨	舍
掇	挽
掉	棹 櫂
掩	揜 揞
揅	研
揜	掩
揝	攢
揞	掩
揭	結
搵	按
摔	甩
摭	拓
摴	舒
撍	攢
撢	撣
撣	撢
擄	虜
擔	担
擡	抬
攢	揝 撍
敁	拈
敕	勅
文	㒚 穩
斋	齊
斍	覺
斝	檟
旁	傍
晁	朝
晰	晳
晳	晰
暖	娠 煖
曳	拽
最	冣
朝	晁
期	逞
朦	矇
朧	矓
朵	朶
朶	朵
杓	捉
柏	孛
某	厶
柒	七
栢	孛
桌	棹
棹	卓 掉 桌
榨	酢
檟	斝
櫂	掉
櫻	蘡
欬	咳
欸	唉
歹	𣦵 𣦶
殍	莩
殻	殼
殼	壳 殻
毉	瑿 醫
汨	汩
汩	汨
汫	阱
沈	沉
沉	沈
沒	没
没	沒
泡	箔
泥	坭
涶	唾
淊	淹
淡	澹
淨	凈
淹	淊
渨	偎
湑	醑
溯	㴑
溺	尿
滾	菌
潦	澇
澇	潦
澹	淡
炫	衒
炮	炰
炰	炮
炸	煠
烟	菸
煖	娠 暖 諼
煙	菸
煠	炸
熨	㷉 尉
燕	鷰
牠	它
牴	牴 觝
犄	踦
犇	奔
獃	呆
瑿	毉
甩	摔
画	畫
畊	耕
畫	画
當	当
畺	將
疆	將
痲	痳
痳	痲
瘉	愈
瘧	弄
盪	逿 𨌩
眠	緡
着	著
矇	朦
矓	朧
矰	蹭
研	揅
硬	應
祇	只
祢	你 妳 您 袮
离	離
秉	拼
秤	稱
稱	秤
穎	署
穩	文
窕	阿
窶	寠
竜	龍
箇	個
箒	帚
箔	泡
節	卩
粘	黏
結	揭
絖	纊
絣	背
緡	眠
縕	韞
繢	繪
繪	繢
纂	臇 𤎱
纊	絖
纔	才
罈	墰
署	穎
羶	膻
翼	折
耒	來
耕	畊
聚	冣
聽	听
肆	四
肕	韌
胄	伷 咮
背	絣
脅	勰
脈	衇
脉	衇
腌	醃 骯
膻	羶
膾	鱠
臇	纂
舀	外
興	㒷
舍	捨
舒	摴
舖	鋪
艑	扁
苛	哼
莩	殍
莿	刺
菌	滾
華	崋 蕐
菸	烟 煙
著	着 螫
蔞	褸
蔴	麻
蕐	華
薓	參
蘡	櫻
處	処 嗻 䖏
虜	擄
號	号
蜋	螂
蜡	䄍 蠟
蜨	蝶
蝦	鰕
蝶	蜨
螂	蜋
螫	著
蠟	蜡
衇	脈 脉
衒	炫
衣	衤
衤	衣
袮	你 妳 您 祢
裏	裡
裒	鴄
裡	裏
褸	蔞
襜	輦
覌	觀
覺	斍
觀	覌
觝	牴
解	觧
觧	解
訴	愬
詐	𧧻 醡
詬	呴
諤	囮
諼	煖
譽	域
讎	仇
讐	仇
財	才
責	拆
貳	二 弍
賺	贃 𧸖
贃	賺
趄	跙
跐	跴
跙	趄
跡	速
跴	跐
踦	犄
蹟	速
蹭	矰
蹶	蹷
蹷	蹶
軲	轂
載	儎
輦	襜
轂	軲
迆	迤
这	這
远	遠
迤	迆
迨	逮
迹	速
這	这
逞	期
速	跡 蹟 迹
逮	迨
逿	盪 𨌩
遠	远
酉	酋
酋	酉
酢	榨
酹	儡
醃	腌
醑	湑
醒	惺
醡	詐
醫	毉
釵	叉
鉈	匜
銼	剉
鋪	舖
鍺	堵
門	门
閒	間
間	閒
门	門
阖	𬮤
阨	呃
阱	汫
阿	啊 窕
降	夅
陣	陳
陳	陣
陸	六
隈	偎
难	難
雕	鵰
雙	双
離	离
難	难
雨	馭
鞋	𩋧
韌	肕
韞	縕
顖	囟
願	愿
餒	餧
餧	喂 餒
餵	喂
馭	御 雨
骯	腌
骾	鯁
鬣	巤
鯁	骾
鰕	蝦
鱠	膾
鴄	裒
鵰	彫 雕
鷰	燕
麻	蔴
黏	粘
齊	斋 齋 齐
齋	齊
齐	齊
齧	囓
龍	竜
龢	和
𠂤	堆
𠦌	𠦜
𠦜	卌 𠦌
𡞾	嫰
𢊍	厨
𣦵	歹
𣦶	歹
𤎱	纂
𤕭	將
𧧻	詐
𧸖	賺
𨌩	盪 逿
𩋧	鞋
𪨗	𫏋
𫏋	𪨗
𬮤	阖
