㑮	𫝈
㑯	㑔
㑳	㑇
㑶	㐹
㒓	𠉂
㒣	𬾖
㓄	𪠟
㓨	刾
㔃	𫦌
㔅	𫦅
㔋	𪟎
㔝	𫦩
㔢	𫦳
㖮	𪠵
㗙	𫩩
㗣	𫪺
㗲	𠵾
㗻	𫪀
㗼	𫩤
㗿	𪡛
㘉	𠰱
㘓	𪢌
㘔	㗷
㘙	𫪂
㘚	㘎
㛝	𫝦
㜄	㚯
㜏	㛣
㜐	𫝧
㜗	𡞋
㜢	𡞱
㜥	𫰨
㜩	𪦂
㜭	𫰠
㜮	𫱕
㜷	𡝠
㜺	𫲗
㝞	𫳃
㞞	𪨊
㟺	𪩇
㠁	𫶅
㠏	㟆
㠣	𫵷
㡓	𫷅
㢗	𪪑
㢝	𢋈
㤲	𫺁
㥮	㤘
㦎	𢛯
㦐	𭜚
㦖	𫺓
㦛	𢗓
㦞	𪫷
㦦	𫻁
㦭	𭝋
㨟	𫼥
㨥	𫽀
㨻	𪮃
㩋	𪮋
㩌	𫽧
㩜	㨫
㩭	𫽊
㩳	㧐
㩵	擜
㪎	𪯋
㪹	𬖠
㪻	𫿳
㬣	𬀮
㯤	𣘐
㰅	𭫙
㰍	𬺜
㰙	𣗙
㰰	𬅢
㰳	𭭈
㵍	𬇰
㵒	𬈕
㵗	𣳆
㵾	𪷍
㶆	𫞛
㷍	𤆢
㷻	𭴊
㷿	𤈷
㸇	𤎺
㸊	𬋍
㸐	𬊾
㹂	𬌛
㹽	𫞣
㺏	𤠋
㺑	𬌷
㺜	𪺻
㻶	𪼋
㼂	𭸼
㼆	𬎆
㼈	𭹜
㾵	𬏟
㾺	𬏜
㿎	𬏷
㿖	𪽮
㿗	𤻊
㿧	𤽯
䀉	𥁢
䀹	𥅴
䁪	𥇢
䁱	𬑒
䁻	䀥
䂎	𥎝
䃘	𬒎
䃤	𬒕
䃮	鿎
䅐	𫀨
䅳	𫀬
䆉	𫁂
䉍	𬕊
䉑	𫁲
䉙	𥬀
䉬	𫂈
䉱	𬕦
䉲	𥮜
䉶	𫁷
䊭	𥺅
䊲	𬡻
䊵	𮉠
䊷	䌶
䊺	𫄚
䋃	𫄜
䋎	𬘜
䋏	𮉣
䋐	𬘙
䋔	𫄞
䋙	䌺
䋚	䌻
䋞	𮉦
䋦	𫄩
䋹	䌿
䋺	𬘴
䋻	䌾
䋼	𫄮
䋾	𬘲
䋿	𦈓
䌁	𬘱
䌈	𦈖
䌋	𦈘
䌐	𬘮
䌖	𦈜
䌝	𦈟
䌞	𬘪
䌟	𦈞
䌥	𦈠
䌪	𬙁
䌰	𦈙
䍤	𫅅
䍦	䍠
䍷	𬙭
䍽	𦍠
䎘	𬚄
䎙	𫅭
䎱	䎬
䐣	𬁽
䐷	𬂅
䑁	𫆙
䑗	𬛹
䓣	𬜯
䔡	𬝁
䕤	𫟕
䕳	𦰴
䕼	𬝴
䖅	𫟑
䗅	𫊪
䗻	𮔂
䗿	𧉞
䙃	𫋸
䙔	𫋲
䙡	䙌
䙱	𧜭
䚆	𬢑
䚉	𬢐
䚩	𫌯
䚳	𬣛
䚵	𬣟
䚽	𬣜
䛄	𫍠
䛍	𬣧
䛘	𬣯
䛛	𬣬
䛞	𬣸
䛤	𬣹
䛬	𬤁
䛳	𫍫
䛽	𬤌
䛿	𬤑
䜀	䜧
䜉	𬤘
䜋	𬤉
䜍	𬤟
䜎	𬣿
䜒	𬤡
䜖	𫟢
䜚	𬤪
䜝	𬤬
䝕	𬥄
䝭	𫎧
䝯	𬥵
䝻	𧹕
䝼	䞍
䞀	𬥽
䞁	𬥺
䞂	𬥻
䞈	𧹑
䞋	𫎪
䞓	𫎭
䟃	𫎺
䟆	𫎳
䟐	𫎱
䟺	𬦥
䠆	𫏃
䠮	𬧃
䠱	𨅛
䡁	𬧢
䡐	𫟤
䡗	𬨆
䡘	𬨉
䡟	𬨌
䡦	𬨑
䡩	𫟥
䡱	𮝀
䡵	𫟦
䡶	𬨔
䡺	𫐕
䢨	𨑹
䤤	𫟺
䤩	𬭈
䤪	𬭆
䤼	𬭣
䥄	𫠀
䥇	䦂
䥑	鿏
䥕	𬭯
䥗	𫔋
䥛	𬭴
䥞	𬭻
䥩	𨱖
䥯	𫔆
䥱	䥾
䥶	𬫂
䦌	𮤬
䦘	𨸄
䦛	䦶
䦝	𬮨
䦟	䦷
䦯	𫔵
䦳	𨷿
䧞	𬮺
䧢	𨸟
䪊	𫖅
䪏	𩏼
䪓	𬰳
䪗	𩐀
䪘	𩏿
䪜	𬰷
䪴	𫖫
䪾	𫖬
䫀	𫖱
䫂	𫖰
䫈	𬱣
䫉	𬥈
䫏	𬱦
䫐	𬃲
䫜	𬱮
䫟	𫖲
䫠	𬱰
䫩	𬱬
䫴	𩖗
䫵	𬱲
䫶	𫖺
䫻	𫗇
䫼	𬱷
䫾	𫠈
䬂	𬱸
䬍	𬲀
䬎	𬱿
䬓	𫗊
䬘	𩙮
䬝	𩙯
䬞	𩙧
䬧	𫗟
䬫	𬲮
䬯	𬲫
䬲	𬲯
䬶	𬲷
䬾	𬲻
䭀	𩠇
䭃	𩠈
䭅	𬲾
䭇	𬳀
䭉	𬳅
䭑	𫗱
䭒	𬳋
䭔	𫗰
䭕	𬲕
䭘	𬳑
䭞	𬲳
䭢	𬲲
䭣	𬲶
䭭	𬱯
䭿	𩧭
䮄	𫠊
䮈	𬳾
䮗	𬴁
䮝	𩧰
䮞	𩨁
䮠	𩧿
䮫	𩨇
䮰	𫘮
䮳	𩨏
䮸	𬳸
䮽	𬴍
䮾	𩧪
䮿	𬴏
䯀	䯅
䯤	𩩈
䰷	𬶆
䰾	鲃
䱀	𫚐
䱁	𫚏
䱓	𬶓
䱗	𮬞
䱙	𩾈
䱚	𮬠
䱛	𮬟
䱧	𫚠
䱬	𩾊
䱰	𩾋
䱱	𬶤
䱵	𮬢
䱷	䲣
䱸	𫠑
䱹	𬶣
䱻	𮬡
䱽	䲝
䲁	鳚
䲅	𫚜
䲏	𬶗
䲕	𬶴
䲖	𩾂
䲗	𮬣
䲘	鳤
䲙	𬶎
䲨	𬷾
䲰	𪉂
䲸	𮭡
䲼	𬸆
䳍	𮭥
䳜	𫛬
䳢	𫛰
䳤	𫛮
䳧	𫛺
䳨	𬸛
䳫	𫛼
䴈	𬸩
䴉	鹮
䴋	𫜅
䴚	𮭰
䴬	𪎈
䴭	𬹅
䴱	𫜒
䴴	𪎋
䴷	𬹉
䴽	𫜔
䵖	𬹔
䵘	𬓸
䵳	𪑅
䵴	𫜙
䶕	𫜨
䶗	𮯙
䶢	𬺍
䶣	𬺃
䶦	𬺉
䶪	𬺕
䶲	𫜳
丟	丢
並	并
乾	干 乾
亂	乱
亙	亘
亞	亚
伕	夫
佇	伫
佈	布
佔	占
併	并
來	来
侖	仑
侶	侣
侷	局
俁	俣
係	系
俓	𠇹
俔	伣
俠	侠
俥	伡
俬	私
倀	伥
倆	俩
倈	俫
倉	仓
個	个
們	们
倖	幸
倣	仿
倫	伦
倲	㑈
偉	伟
偑	㐽
側	侧
偵	侦
偺	咱
偽	伪
傌	㐷
傑	杰
傖	伧
傘	伞
備	备
傚	效
傢	家
傪	𫢺
傭	佣
傯	偬
傳	传
傴	伛
債	债
傷	伤
傾	倾
僂	偻
僅	仅
僆	𫢪
僉	佥
僑	侨
僕	仆
僗	𫢬
僞	伪
僤	𫢸
僥	侥
僨	偾
僭	僣
僱	雇
價	价
僾	𫣊
儀	仪
儁	俊
儂	侬
億	亿
儅	当
儈	侩
儉	俭
儎	傤
儐	傧
儔	俦
儕	侪
儘	尽 侭
償	偿
儣	𠆲
優	优
儭	𠋆
儰	𫢭
儲	储
儷	俪
儸	㑩 罗
儺	傩
儻	傥
儼	俨
兇	凶
兌	兑
兒	儿
兗	兖
內	内
兩	两
冊	册
冑	胄
冪	幂
凈	净
凍	冻
凙	𪞝
凜	凛
凱	凯
別	别
刪	删
剄	刭
則	则
剋	克
剎	刹
剗	刬
剛	刚
剝	剥
剮	剐
剴	剀
創	创
剷	铲
剾	𠛅
劃	划 㓰
劇	剧
劉	刘
劊	刽
劌	刿
劍	剑
劏	㓥
劑	剂
劗	𭄛
劚	㔉
勁	劲
勑	𠡠
動	动
勗	勖
務	务
勛	勋
勝	胜
勞	劳
勢	势
勣	绩 𪟝
勦	剿
勩	勚
勱	劢
勳	勋
勵	励
勸	劝
勻	匀
匭	匦
匯	汇
匱	匮
區	区
協	协
卨	𫧯
卹	恤
卻	却
卽	即
厙	厍
厠	厕
厤	历
厭	厌
厲	厉
厴	厣
參	参
叄	叁
叢	丛
吒	咤
吳	吴
吶	呐
呂	吕
咼	呙
員	员
哯	𠯟
唄	呗
唓	𪠳
唚	吣
唸	念
唻	𫪁
問	问
啓	启
啞	哑
啟	启
啢	唡
喎	㖞
喚	唤
喪	丧
喫	吃
喬	乔
單	单
喲	哟
嗆	呛
嗇	啬
嗊	唝
嗎	吗
嗚	呜
嗩	唢
嗰	𠮶
嗶	哔
嗹	𪡏
嘄	𫪧
嘆	叹
嘍	喽
嘓	啯
嘔	呕
嘖	啧
嘗	尝
嘜	唛
嘩	哗
嘪	𪡃
嘮	唠
嘯	啸
嘰	叽
嘳	𪡞
嘵	哓
嘸	呒
嘺	𪡀
嘽	啴
噁	恶 𫫇
噅	𠯠
噓	嘘
噚	㖊
噝	咝
噞	𪡋
噠	哒
噣	𫩮
噥	哝
噦	哕
噯	嗳
噲	哙
噴	喷
噸	吨
噹	当 𪠽
嚀	咛
嚇	吓
嚈	𫩫
嚌	哜
嚍	𫩺
嚐	尝
嚕	噜
嚙	啮
嚛	𪠸
嚠	𭇯
嚥	咽
嚦	呖
嚧	𠰷
嚨	咙
嚪	𫫦
嚬	𫫾
嚮	向
嚲	亸
嚳	喾
嚴	严
嚶	嘤
嚽	𪢕
嚿	𫩥
囀	啭
囁	嗫
囂	嚣
囃	𠱞
囅	冁
囇	𫪃
囈	呓
囉	啰
囌	苏
囑	嘱
囒	𫩪
囪	囱
圇	囵
國	国
圍	围
園	园
圓	圆
圖	图
團	团
圞	𪢮
垵	埯
埡	垭
埬	𪣆
埰	采
執	执
堅	坚
堊	垩
堖	垴
堚	𪣒
堝	埚
堯	尧
報	报
場	场
塊	块
塋	茔
塏	垲
塒	埘
塗	涂
塚	冢
塢	坞
塤	埙
塵	尘
塸	𫭟
塹	堑
塼	𫭞
塿	𪣻
墊	垫
墋	𫮅
墜	坠
墝	𫭪
墠	𫮃
墢	𫭨
墮	堕
墰	坛
墲	𪢸
墳	坟
墶	垯
墻	墙
墾	垦
壇	坛
壈	𡒄
壋	垱
壎	埙
壓	压
壗	𡋤
壘	垒
壙	圹
壚	垆
壜	坛
壞	坏
壟	垄
壠	垅
壢	坜
壣	𪤚
壧	𫭲
壩	坝
壪	塆
壯	壮
壺	壶
壼	壸
壽	寿
夠	够
夢	梦
夥	伙
夾	夹
奐	奂
奧	奥
奩	奁
奪	夺
奫	𫯶
奬	奖
奮	奋
奲	𫰂
奼	姹
妝	妆
姍	姗
姦	奸
娙	𫰛
娛	娱
婁	娄
婜	𫰐
婡	𫝫
婣	𫰿
婦	妇
婭	娅
媁	𫰍
媈	𫝨
媧	娲
媯	妫
媰	㛀
媼	媪
媽	妈
嫋	袅
嫗	妪
嫢	𫰹
嫵	妩
嫺	娴
嫻	娴
嫿	婳
嬀	妫
嬃	媭
嬅	𫰡
嬇	𫝬
嬈	娆
嬋	婵
嬌	娇
嬐	𫰰
嬒	𫰢
嬙	嫱
嬡	嫒
嬣	𪥰
嬤	嬷
嬦	𫝩
嬪	嫔
嬰	婴
嬸	婶
嬻	𪥿
孃	娘
孄	𫝮
孆	𫝭
孇	𪥫
孋	㛤
孌	娈
孎	𡠟
孫	孙
學	学
孻	𡥧
孾	𪧀
孿	孪
宮	宫
寀	采
寠	𪧘
寢	寝
實	实
寧	宁
審	审
寫	写
寬	宽
寵	宠
寶	宝
將	将
專	专
尋	寻
對	对
導	导
尷	尴
屆	届
屍	尸
屓	屃
屜	屉
屢	屡
層	层
屨	屦
屩	𪨗
屬	属
屭	屃
岡	冈
峯	峰
峴	岘
島	岛
峽	峡
崍	崃
崑	昆
崗	岗
崙	仑 𪨧
崠	岽
崢	峥
崬	岽
崵	𫵵
嵐	岚
嵒	岩
嵗	岁
嵼	𡶴
嵽	𫶇
嵾	㟥
嶁	嵝
嶄	崭
嶇	岖
嶈	𡺃
嶔	嵚
嶗	崂
嶘	𡺄
嶠	峤
嶢	峣
嶧	峄
嶨	峃
嶮	崄
嶴	岙
嶸	嵘
嶹	𫝵
嶺	岭
嶼	屿
嶽	岳
巊	𪩎
巋	岿
巒	峦
巔	巅
巖	岩
巗	𪨷
巘	𪩘
巰	巯
巹	卺
帥	帅
師	师
帳	帐
帶	带
幀	帧
幃	帏
幓	㡎
幗	帼
幘	帻
幝	𪩷
幟	帜
幣	币
幩	𪩸
幫	帮
幬	帱
幹	干
幺	么
幾	几
座	坐
庫	库
庲	𫷬
廁	厕
廂	厢
廄	厩
廈	厦
廎	庼
廔	𫷹
廕	荫 𫷮
廙	𫷩
廚	厨
廝	厮
廞	𫷷
廟	庙
廠	厂
廡	庑
廢	废
廣	广
廧	𪪞
廩	廪
廬	庐 𪪏
廮	𫷾
廳	厅
弒	弑
弔	吊
弳	弪
張	张
強	强
彃	𪪼
彄	𫸩
彆	别
彈	弹
彌	弥
彎	弯
彔	录
彙	汇
彞	彝
彠	彟
彥	彦
彫	雕
彲	彨
彷	彷 仿
彿	佛
後	后
徑	径
從	从
徠	徕
復	复
徵	征 徵
徹	彻
徿	𪫌
恆	恒
恥	耻
悅	悦
悏	𫺂
悞	悮
悵	怅
悶	闷
悽	凄
惡	恶
惱	恼
惲	恽
惻	恻
愇	𫹴
愛	爱
愜	惬
愨	悫
愩	𫺌
愴	怆
愷	恺
愻	𢙏
愾	忾
慄	栗
態	态
慍	愠
慘	惨
慚	惭
慟	恸
慣	惯
慤	悫
慪	怄
慫	怂
慮	虑
慯	𫹽
慳	悭
慶	庆
慺	㥪
慼	戚
慾	欲
憂	忧
憊	惫
憐	怜
憑	凭
憒	愦
憖	慭
憚	惮
憢	𢙒
憤	愤
憦	𫺘
憫	悯
憮	怃
憲	宪
憶	忆
憸	𪫺
憹	𢙐
懀	𢙓
懇	恳
應	应
懌	怿
懍	懔
懎	𢠁
懓	𭞄
懞	蒙
懟	怼
懠	𫺊
懢	𪬌
懣	懑
懤	㤽
懨	恹
懩	𫺪
懲	惩
懶	懒
懷	怀
懸	悬
懺	忏
懼	惧
懾	慑
戀	恋
戁	𫺷
戇	戆
戔	戋
戧	戗
戩	戬
戰	战 𢧐
戱	戯
戲	戏
戶	户
拋	抛
挩	捝
挱	挲
挾	挟
捨	舍
捫	扪
捱	挨
捲	卷
掃	扫
掄	抡
掆	㧏
掗	挜
掙	挣
掚	𪭵
掛	挂
採	采
揀	拣
揚	扬
換	换
揮	挥
揯	搄
揹	背
搊	𫼝
損	损
搖	摇
搗	捣
搵	揾
搶	抢
摀	捂
摃	𫼱
摋	𢫬
摌	𫼪
摐	𪭢
摑	掴
摙	𫽁
摜	掼
摟	搂
摥	𫼟
摪	𫽣
摯	挚
摳	抠
摶	抟
摺	折
摻	掺
撈	捞
撊	𪭾
撍	𭢗
撏	挦
撐	撑
撓	挠
撝	㧑
撟	挢
撣	掸
撥	拨
撧	𪮖
撫	抚
撲	扑
撳	揿
撶	𫼧
撻	挞
撾	挝
撿	捡
擁	拥
擃	𫼮
擄	掳
擇	择
擈	𭠙
擊	击
擋	挡
擓	㧟
擔	担
據	据
擟	𪭧
擠	挤
擡	抬
擣	捣 𢭏
擫	𢬍
擬	拟
擯	摈
擰	拧
擱	搁
擲	掷
擴	扩
擷	撷
擺	摆
擻	擞
擼	撸
擽	㧰
擾	扰
攄	摅
攆	撵
攋	𪮶
攏	拢
攑	𫽥
攔	拦
攖	撄
攙	搀
攛	撺
攜	携
攝	摄
攞	𫽋
攢	攒
攣	挛
攤	摊
攩	𫽮
攪	搅
攬	揽
敎	教
敓	敚
敗	败
敘	叙
敵	敌
數	数
斁	𭣧
斂	敛
斃	毙
斅	𢽾
斆	敩
斕	斓
斬	斩
斷	断
斸	𣃁
於	于 於
旂	旗
旣	既
昇	升
時	时
晉	晋
晛	𬀪
晝	昼
暈	晕
暉	晖
暐	𬀩
暘	旸
暟	𬀱
暢	畅
暫	暂
暱	昵
曄	晔
曆	历
曇	昙
曉	晓
曊	𪰶
曏	向 𬁠
曖	暧
曠	旷
曥	𣆐
曨	昽
曬	晒
曭	𭧋
書	书
會	会
朥	𦛨
朦	𬂓
朧	胧
朮	术
東	东
杴	锨
枴	拐
柵	栅
柺	拐
査	查
桱	𣐕
桿	杆
梔	栀
梖	𪱷
梘	枧
條	条
梟	枭
梱	捆
梲	棁
棄	弃
棊	棋
棖	枨
棗	枣
棟	栋
棡	㭎
棧	栈
棲	栖
棶	梾
椏	桠
椚	𭩛
椲	㭏
楇	𣒌
楊	杨
楓	枫
楨	桢
業	业
極	极
榘	矩
榦	干
榪	杩
榮	荣
榲	榅
榿	桤
構	构
槍	枪
槓	杠
槤	梿
槧	椠
槨	椁
槫	𣏢
槮	椮
槳	桨
槶	椢
槻	𬃀
槼	椝
樁	桩
樂	乐
樅	枞
樑	梁
樓	楼
標	标
樞	枢
樠	𣗊
樢	㭤
樣	样
樤	𣔌
樧	𬂮
樫	㭴
樲	𬃘
樳	桪
樸	朴
樹	树
樺	桦
樻	𭫀
樿	椫
橃	𭩰
橅	𬂠
橈	桡
橋	桥
機	机
橢	椭
橫	横
橯	𣓿
檁	檩
檂	𬂰
檉	柽
檒	𮨴
檔	档
檛	𭪆
檜	桧
檟	槚
檢	检
檣	樯
檥	𭩚
檭	𣘴
檮	梼
檯	台
檳	槟
檵	𪲛
檷	𪱾
檸	柠
檻	槛
檾	苘
櫂	棹
櫃	柜
櫅	𪲎
櫍	𬃊
櫓	橹
櫚	榈
櫛	栉
櫝	椟
櫞	橼
櫟	栎
櫠	𪲮
櫥	橱
櫧	槠
櫨	栌
櫪	枥
櫫	橥
櫬	榇
櫱	蘖
櫳	栊
櫶	𬃫
櫸	榉
櫺	棂
櫻	樱
櫽	𬄩
欄	栏
欅	榉
欇	𪳍
權	权
欍	𣐤
欏	椤
欐	𪲔
欑	𪴙
欒	栾
欓	𣗋
欖	榄
欘	𣚚
欞	棂
欽	钦
歄	𬅥
歎	叹
歐	欧
歞	𪴯
歟	欤
歡	欢
歲	岁
歷	历
歸	归
歿	殁
殘	残
殞	殒
殢	𣨼
殤	殇
殨	㱮
殫	殚
殭	僵
殮	殓
殯	殡
殰	㱩
殲	歼
殺	杀
殻	壳
殼	壳
毀	毁
毄	𬆦
毆	殴
毊	𪵑
毚	𫥎
毿	毵
氂	牦
氈	毡
氌	氇
氣	气
氫	氢
氬	氩
氭	𣱝
氳	氲
氾	泛
汎	泛
汙	污
決	决
沈	沈 沉
沒	没
沖	冲
況	况
泝	溯
洩	泄
洶	汹
浹	浃
浿	𬇙
涇	泾
涗	涚
涼	凉
淒	凄
淚	泪
淥	渌
淨	净
淩	凌
淪	沦
淵	渊
淶	涞
淺	浅
渙	涣
減	减
渢	沨
渦	涡
測	测
渾	浑
湊	凑
湋	𣲗
湞	浈
湧	涌
湯	汤
溈	沩
準	准
溝	沟
溡	𪶄
溫	温
溮	浉
溳	涢
溼	湿
滄	沧
滅	灭
滌	涤
滎	荥
滙	汇
滬	沪
滯	滞
滲	渗
滷	卤
滸	浒
滻	浐
滾	滚
滿	满
漁	渔
漊	溇
漍	𬇹
漙	𬇘
漚	沤
漢	汉
漣	涟
漬	渍
漲	涨
漵	溆
漸	渐
漿	浆
潁	颍
潑	泼
潔	洁
潕	𣲘
潙	沩
潚	㴋
潛	潜
潣	𫞗
潤	润
潬	𬈁
潯	浔
潰	溃
潷	滗
潿	涠
澀	涩
澅	𣶩
澆	浇
澇	涝
澐	沄
澒	𭱊
澗	涧
澠	渑
澢	𭰎
澤	泽
澦	滪
澩	泶
澫	𬇕
澬	𫞚
澮	浍
澱	淀
澳	𪶓
澾	㳠
濁	浊
濃	浓
濄	㳡
濆	𣸣
濇	𬈧
濔	沵
濕	湿
濘	泞
濚	溁
濛	蒙
濜	浕
濟	济
濤	涛
濦	𬈬
濧	㳔
濫	滥
濰	潍
濱	滨
濺	溅
濼	泺
濾	滤
濿	𪵱
瀂	澛
瀃	𣽷
瀅	滢
瀆	渎
瀇	㲿
瀉	泻
瀋	沈 渖
瀏	浏
瀕	濒
瀘	泸
瀝	沥
瀟	潇
瀠	潆
瀢	𬉋
瀦	潴
瀧	泷
瀨	濑
瀩	𬉏
瀰	弥 㳽
瀲	潋
瀵	𬉂
瀾	澜
灃	沣
灄	滠
灆	𪷞
灍	𫞝
灑	洒
灒	𪷽
灕	漓
灘	滩
灙	𣺼
灝	灏
灟	𭲫
灠	漤
灡	㳕
灣	湾
灤	滦
灧	滟
灩	滟
災	灾
為	为
烏	乌
烴	烃
焛	𬮟
無	无
煇	𪸩
煉	炼
煒	炜
煙	烟
煢	茕
煥	焕
煩	烦
煬	炀
煱	㶽
煼	𬊂
熂	𪸕
熅	煴
熉	𤈶
熌	𤇄
熒	荧
熓	𤆡
熕	𬊎
熗	炝
熚	𤇹
熡	𤋏
熰	𬉼
熱	热
熲	颎
熾	炽
燀	𬊤
燁	烨
燈	灯
燉	炖
燒	烧
燖	𬊈
燘	𬊖
燙	烫
燜	焖
營	营
燦	灿
燬	毁
燭	烛
燰	𬊺
燴	烩
燵	𬊉
燶	㶶
燻	熏
燼	烬
燽	𬊍
燾	焘
爁	𬊶
爃	𫞡
爄	𤇃
爇	𦶟
爍	烁
爐	炉
爖	𤇭
爛	烂
爣	𬊵
爥	𪹳
爧	𫞠
爭	争
爲	为
爺	爷
爾	尔
爿	丬
牀	床
牆	墙
牘	牍
牠	它
牴	牴 抵
牽	牵
犓	𬌝
犖	荦
犛	牦
犞	𪺭
犢	犊
犧	牺
狀	状
狹	狭
狽	狈
猌	𪺽
猙	狰
猶	犹
猻	狲
獁	犸
獃	呆
獄	狱
獅	狮
獊	𪺷
獎	奖
獟	𬌮
獨	独
獩	𤞃
獪	狯
獫	猃
獮	狝
獰	狞
獱	㺍
獲	获
獵	猎
獷	犷
獸	兽
獺	獭
獻	献
獼	猕
玀	猡
玁	𤞤
珼	𫞥
現	现
琖	𬍙
琱	雕
琺	珐
琿	珲
瑋	玮
瑒	玚
瑠	𭹗
瑣	琐
瑤	瑶
瑩	莹
瑪	玛
瑯	琅
瑲	玱
瑻	𪻲
瑽	𪻐
璉	琏
璊	𫞩
璕	𬍤
璗	𬍡
璝	𪻺
璡	琎
璣	玑
璦	瑷
璫	珰
璯	㻅
環	环
璵	玙
璸	瑸
璺	𭸼
璼	𫞨
璽	玺
璾	𫞦
璿	璇
瓄	𪻨
瓅	𬍛
瓊	琼
瓏	珑
瓓	𬎑
瓔	璎
瓕	𤦀
瓚	瓒
瓛	𤩽
甌	瓯
甕	瓮
產	产
産	产
甦	苏
甯	宁
畝	亩
畢	毕
畫	画 划
異	异
畵	画
當	当
畼	𪽈
疇	畴
疊	叠
痙	痉
痠	酸
痮	𪽪
痾	疴
瘂	痖
瘋	疯
瘍	疡
瘑	𬏮
瘒	𬏫
瘓	痪
瘞	瘗
瘡	疮
瘧	疟
瘮	瘆
瘱	𪽷
瘲	疭
瘺	瘘
瘻	瘘
療	疗
癆	痨
癇	痫
癈	𬏦
癉	瘅
癐	𤶊
癒	愈
癘	疠
癟	瘪
癡	痴
癢	痒
癤	疖
癥	症
癧	疬
癩	癞
癬	癣
癭	瘿
癮	瘾
癰	痈
癱	瘫
癲	癫
發	发
皁	皂
皚	皑
皟	𤾀
皰	疱
皸	皲
皺	皱
盃	杯
盜	盗
盞	盏
盡	尽
監	监
盤	盘
盧	卢
盨	𪾔
盪	荡
眝	𪾣
眞	真
眥	眦
眾	众
睍	𪾢
睏	困
睜	睁
睞	睐
睴	𬑕
睾	睪 睾
瞘	眍
瞜	䁖
瞞	瞒
瞤	𥆧
瞭	了 瞭
瞱	𬑓
瞶	瞆
瞷	𬑗
瞼	睑
矇	蒙
矉	𪾸
矑	𪾦
矓	眬
矚	瞩
矯	矫
砲	炮
硃	朱
硜	硁
硤	硖
硨	砗
硯	砚
碕	埼
碙	𥐻
碩	硕
碭	砀
碸	砜
確	确
碼	码
碽	䂵
磑	硙
磒	𬒍
磚	砖
磠	硵
磣	碜
磧	碛
磯	矶
磱	𮀤
磽	硗
磾	䃅
礄	硚
礆	硷
礎	础
礏	𬒆
礒	𥐟
礙	碍
礜	𪿝
礦	矿
礪	砺
礫	砾
礬	矾
礮	𪿫
礱	砻
祇	祇 只
祕	秘
祿	禄
禍	祸
禎	祯
禕	祎
禡	祃
禦	御
禪	禅
禮	礼
禰	祢
禱	祷
禿	秃
秈	籼
稅	税
稈	秆
稏	䅉
稜	棱
稟	禀
種	种
稱	称
穀	谷
穇	䅟
穌	稣
積	积
穎	颖
穠	秾
穡	穑
穢	秽
穨	𬓼
穩	稳
穫	获
穭	穞 稆
窩	窝
窪	洼
窮	穷
窯	窑
窵	窎
窶	窭
窺	窥
竄	窜
竅	窍
竇	窦
竈	灶
竊	窃
竚	𥩟
竪	竖
竱	𫁟
競	竞
筆	笔
筍	笋
筧	笕
筴	䇲
箇	个
箋	笺
箏	筝
箠	棰
節	节
範	范
築	筑
篋	箧
篔	筼
篘	𥬠
篠	筿
篢	𬕂
篤	笃
篩	筛
篳	筚
篸	𥮾
簀	箦
簂	𫂆
簍	篓
簑	蓑
簞	箪
簡	简
簢	𫂃
簣	篑
簫	箫
簹	筜
簽	签
簾	帘
籃	篮
籅	𥫣
籋	𥬞
籌	筹
籔	䉤
籙	箓
籛	篯
籜	箨
籟	籁
籠	笼
籣	𮆏
籤	签
籩	笾
籪	簖
籫	𬖃
籬	篱
籭	𬕄
籮	箩
籲	吁
粯	𬖑
粵	粤
粹	𬖚
糉	粽
糝	糁
糞	粪
糧	粮
糮	𬖮
糰	团
糲	粝
糴	籴
糶	粜
糹	纟
糺	𫄙
糾	纠
紀	纪
紂	纣
紃	𬘓
約	约
紅	红
紆	纡
紇	纥
紈	纨
紉	纫
紋	纹
紌	𬘕
納	纳
紐	纽
紓	纾
純	纯
紕	纰
紖	纼
紗	纱
紘	纮
紙	纸
級	级
紛	纷
紜	纭
紝	纴
紞	𬘘
紟	𫄛
紡	纺
紩	𮉢
紬	䌷
紮	扎
細	细
紱	绂
紲	绁
紳	绅
紵	纻
紶	𬘛
紹	绍
紺	绀
紼	绋
紾	𬘝
紿	绐
絀	绌
絁	𫄟
終	终
絃	弦
組	组
絅	䌹
絆	绊
絍	纴
絎	绗
結	结
絓	𮉤
絕	绝
絖	𬘢
絙	𫄠
絚	𫄠
絛	绦
絝	绔
絞	绞
絟	𬘥
絠	𬘠
絡	络
絢	绚
絤	𬘟
絥	𫄢
給	给
絧	𫄡
絨	绒
絪	𬘡
絰	绖
統	统
絲	丝
絳	绛
絶	绝
絸	𬘖
絹	绢
絺	𫄨
絽	𬘤
綀	𦈌
綁	绑
綃	绡
綄	𬘫
綆	绠
綇	𦈋
綈	绨
綉	绣
綋	𫟄
綌	绤
綎	𬘩
綏	绥
綐	䌼
綑	捆
經	经
綕	𬘨
綖	𫄧
綜	综
綝	𬘭
綞	缍
綟	𫄫
綠	绿
綡	𫟅
綢	绸
綣	绻
綧	𬘯
綪	𬘬
綫	线
綬	绶
維	维
綯	绹
綰	绾
綱	纲
網	网
綳	绷
綴	缀
綵	彩 䌽
綷	𮉬
綸	纶
綹	绺
綺	绮
綻	绽
綽	绰
綾	绫
綿	绵
緄	绲
緅	𮉪
緇	缁
緉	𮉧
緊	紧
緋	绯
緌	𮉫
緍	𦈏
緑	绿
緒	绪
緓	绬
緔	绱
緗	缃
緘	缄
緙	缂
線	线 缐
緛	𬘰
緝	缉
緞	缎
緟	𫟆
締	缔
緡	缗
緣	缘
緤	𫄬
緦	缌
緧	𬘶
編	编
緩	缓
緪	𫄠
緬	缅
緮	𫄭
緯	纬
緰	𦈕
緱	缑
緲	缈
練	练
緶	缏
緷	𦈉
緸	𦈑
緹	缇
緺	𮉨
緻	致
緼	缊
縆	𫄠
縈	萦
縉	缙
縊	缢
縋	缒
縍	𫄰
縎	𦈔
縐	绉
縑	缣
縒	𬘷
縕	缊
縖	𬘻
縗	缞
縚	𬘺
縛	缚
縝	缜
縞	缟
縟	缛
縣	县
縧	绦
縩	𮉯
縫	缝
縬	𦈚
縭	缡
縮	缩
縯	演 𬙂
縰	𫄳
縱	纵
縲	缧
縳	䌸
縴	纤
縵	缦
縶	絷
縷	缕
縸	𫄲
縹	缥
縺	𦈐
總	总
績	绩
繀	𮉮
繂	𫄴
繃	绷
繅	缫
繆	缪
繈	𫄶
繎	𬙇
繏	𦈝
繐	穗
繒	缯
繓	𦈛
織	织
繕	缮
繗	𬙈
繙	𬙆
繚	缭
繞	绕
繟	𦈎
繡	绣
繢	缋
繨	𫄤
繩	绳
繪	绘
繫	系
繬	𫄱
繭	茧
繮	缰
繯	缳
繰	缲
繳	缴
繵	𬙉
繶	𫄷
繷	𫄣
繸	䍁
繹	绎
繻	𦈡
繼	继
繽	缤
繾	缱
繿	䍀
纁	𫄸
纃	𬘧
纆	𬙊
纇	颣
纈	缬
纊	纩
續	续
纍	累
纏	缠
纑	𮉡
纓	缨
纔	才
纕	𬙋
纖	纤
纗	𫄹
纘	缵
纚	𫄥
纜	缆
缽	钵
罃	䓨
罈	坛
罌	罂
罎	坛
罏	𬙎
罰	罚
罵	骂
罷	罢
罼	𬙝
羅	罗
羆	罴
羈	羁
羋	芈
羜	𬙯
羣	群
羥	羟
羨	羡
義	义
羵	𫅗
羶	膻
習	习
翬	翚
翹	翘
翽	翙
耆	芪
耬	耧
耮	耢
聖	圣
聞	闻
聯	联
聰	聪
聲	声
聳	耸
聵	聩
聶	聂
職	职
聹	聍
聻	𫆏
聽	听
聾	聋
肅	肃
脅	胁
脇	胁
脈	脉
脛	胫
脣	唇
脥	𣍰
脩	修
脫	脱
脹	胀
腎	肾
腖	胨
腡	脶
腦	脑
腪	𣍯
腫	肿
腳	脚
腸	肠
膃	腽
膒	𬁵
膕	腘
膚	肤
膞	䏝
膠	胶
膢	𦝼
膩	腻
膶	𬂀
膹	𪱥
膽	胆
膾	脍
膿	脓
臉	脸
臍	脐
臏	膑
臗	𣎑
臘	腊
臚	胪
臟	脏
臠	脔
臢	臜
臥	卧
臨	临
臺	台
與	与
興	兴
舉	举
舊	旧
舘	馆
艙	舱
艣	橹 𫇛
艤	舣
艦	舰
艪	橹
艫	舻
艱	艰
艷	艳
芻	刍
苧	苎
茲	兹
荊	荆
莊	庄
莖	茎
莢	荚
莧	苋
菕	芲
菣	𬜤
華	华
菴	庵
菸	烟
萇	苌
萊	莱
萬	万
萴	荝
萵	莴
葉	叶
葒	荭
葝	𫈎
葤	荮
葦	苇
葯	药
葷	荤
葻	𬜥
蒍	𫇭
蒐	搜
蒓	莼
蒔	莳
蒕	蒀
蒞	莅
蒭	𫇴
蒼	苍
蓀	荪
蓆	席
蓋	盖
蓧	𦰏
蓮	莲
蓯	苁
蓴	莼
蓽	荜
蔄	𬜬
蔔	卜
蔘	参
蔞	蒌
蔣	蒋
蔥	葱
蔦	茑
蔭	荫
蔮	𬜿
蔯	𫈟
蔿	𫇭
蕁	荨
蕆	蒇
蕎	荞
蕒	荬
蕓	芸
蕕	莸
蕘	荛
蕝	𫈵
蕟	𬜧
蕢	蒉
蕩	荡
蕪	芜
蕭	萧
蕳	𫈉
蕷	蓣
蕽	𫇽
薀	蕰
薆	𫉁
薈	荟
薉	𬜨
薊	蓟
薌	芗
薑	姜
薔	蔷
薘	荙
薟	莶
薦	荐
薩	萨
薰	熏
薲	𬝯
薳	䓕
薴	苧
薵	䓓
薹	苔 薹
薺	荠
藉	藉 借
藍	蓝
藎	荩
藖	𬜾
藝	艺
藥	药
藪	薮
藬	𬞘
藭	䓖
藴	蕴
藶	苈
藷	𫉄
藹	蔼
藺	蔺
蘀	萚
蘄	蕲
蘆	芦
蘇	苏
蘊	蕴
蘋	苹
蘗	蘖
蘚	藓
蘞	蔹
蘟	𦻕
蘢	茏
蘫	𬞫
蘭	兰
蘹	𬜸
蘺	蓠
蘿	萝
虆	蔂
虉	𬟁
處	处
虖	呼
虛	虚
虜	虏
號	号
虧	亏
虯	虬
蛺	蛱
蛻	蜕
蜆	蚬
蜵	𬠔
蜽	𮔊
蝀	𬟽
蝕	蚀
蝜	𮔅
蝟	猬
蝦	虾
蝨	虱
蝸	蜗
螄	蛳
螞	蚂
螢	萤
螮	䗖
螻	蝼
螿	螀
蟂	𫋇
蟄	蛰
蟈	蝈
蟎	螨
蟘	𫋌
蟜	𫊸
蟣	虮
蟧	𮔚
蟬	蝉
蟯	蛲
蟲	虫
蟳	𫊻
蟶	蛏
蟷	𬠅
蟻	蚁
蠀	𧏗
蠁	蚃
蠅	蝇
蠆	虿
蠈	𬠠
蠍	蝎
蠐	蛴
蠑	蝾
蠔	蚝
蠙	𧏖
蠞	𬝋
蠟	蜡
蠣	蛎
蠦	𫊮
蠨	蟏
蠱	蛊
蠶	蚕
蠻	蛮
蠾	𧑏
衆	众
衊	蔑
術	术
衕	同
衚	胡
衛	卫
衝	冲
衹	衹 只
袞	衮
裊	袅
裌	𬡒
裏	里
補	补
裝	装
裡	里
裲	𮖁
製	制
複	复
褌	裈
褘	袆
褲	裤
褳	裢
褸	褛
褺	𬡓
褻	亵
襀	𫌀
襂	𫌄
襆	幞
襇	裥
襉	裥
襏	袯
襓	𫋹
襖	袄
襗	𫋷
襘	𫋻
襝	裣
襠	裆
襤	褴
襪	袜
襬	䙓 摆
襭	𮖱
襯	衬
襰	𧝝
襲	袭
襴	襕
襵	𫌇
襸	𬡷
覆	覆 复
覈	核
見	见
覎	觃
規	规
覒	𬆾
覓	觅
視	视
覗	𬢊
覘	觇
覛	𫌪
覜	𬢋
覟	𬢌
覡	觋
覢	𬊦
覤	𬟪
覥	觍
覦	觎
覩	𬢎
親	亲
覬	觊
覭	𬢒
覯	觏
覲	觐
覴	𬢔
覷	觑
覹	𫌭
覺	觉
覼	𫌨
覽	览
覿	觌
觀	观
觴	觞
觶	觯
觸	触
訁	讠
訂	订
訃	讣
計	计
訊	讯
訌	讧
討	讨
訏	𬣙
訐	讦
訑	𫍙
訒	讱
訓	训
訕	讪
訖	讫
託	托 讬
記	记
訛	讹
訜	𫍛
訝	讶
訞	𫍚
訟	讼
訢	䜣
訣	诀
訥	讷
訨	𫟞
訩	讻
訪	访
設	设
許	许
訴	诉
訶	诃
診	诊
註	注 𬣣
証	证
詀	𧮪
詁	诂
詃	𬣤
詆	诋
詊	𫟟
詌	𬣠
詎	讵
詏	𬣦
詐	诈
詑	𫍡
詒	诒
詓	𫍜
詔	诏
評	评
詖	诐
詗	诇
詘	诎
詛	诅
詜	𬣥
詝	𬣞
詞	词
詠	咏
詡	诩
詢	询
詣	诣
試	试
詩	诗
詪	𬣳
詫	诧
詬	诟
詭	诡
詮	诠
詯	𬣰
詰	诘
話	话
該	该
詳	详
詴	𬣩
詵	诜
詶	𬣱
詷	𫍣
詺	𬣮
詼	诙
詿	诖
誁	𬣲
誂	𫍥
誄	诔
誅	诛
誆	诓
誇	夸
誋	𫍪
誌	志
認	认
誎	𬣷
誏	𬣼
誑	诳
誒	诶
誔	𬣻
誕	诞
誘	诱
誚	诮
語	语
誠	诚
誡	诫
誣	诬
誤	误
誥	诰
誦	诵
誨	诲
說	说
誫	𫍨
説	说
誰	谁
課	课
誳	𫍮
誴	𫟡
誶	谇
誷	𫍬
誹	诽
誺	𫍧
誼	谊
誾	訚
調	调
諂	谄
諄	谆
談	谈
諉	诿
請	请
諍	诤
諎	𬣾
諏	诹
諑	诼
諒	谅
諓	𬣡
諕	𬤀
論	论
諗	谂
諛	谀
諜	谍
諝	谞
諞	谝
諟	𬤊
諠	𬤎
諡	谥
諢	诨
諣	𫍩
諤	谔
諥	𫍳
諦	谛
諧	谐
諫	谏 𫍝
諭	谕
諮	咨 谘
諯	𫍱
諰	𫍰
諱	讳
諲	𬤇
諳	谙
諴	𫍯
諶	谌
諷	讽
諸	诸
諺	谚
諻	𬤍
諼	谖
諾	诺
謀	谋
謁	谒
謂	谓
謄	誊
謅	诌
謆	𫍸
謉	𫍷
謊	谎
謌	𬤐
謎	谜
謏	𫍲
謐	谧
謔	谑
謖	谡
謗	谤
謙	谦
謚	谥
講	讲
謝	谢
謠	谣
謡	谣
謨	谟
謫	谪
謬	谬
謭	谫
謯	𫍹
謰	𬣽
謱	𫍴
謲	𬤄
謳	讴
謴	𬤆
謸	𫍵
謹	谨
謼	呼 𬤙
謾	谩
譁	哗
譂	𫟠
譄	𬤤
譅	䜧
譆	𫍻
譈	𬤣
證	证
譊	𫍢
譎	谲
譏	讥
譐	𬤢
譑	𫍤
譓	𬤝
譔	𬤥
譖	谮
識	识
譙	谯
譚	谭
譜	谱
譞	𫍽
譟	噪 𬤨
譡	𬣭
譨	𫍦
譫	谵
譭	毁
譯	译
議	议
譴	谴
護	护
譸	诪
譹	𬤫
譺	𬤩
譻	𬢯
譽	誉
譾	谫 𫍿
譿	𬤭
讀	读
讅	谉
讆	𬣀
讇	𬤛
讉	𬤦
變	变
讋	詟
讌	䜩
讎	雠
讒	谗
讓	让
讔	𮙊
讕	谰
讖	谶
讙	𬤰
讚	赞 𬤮
讜	谠
讞	谳
讟	𮙋
谿	溪
豈	岂
豎	竖
豐	丰
豔	艳
豬	猪
豵	𫎆
豶	豮
貍	狸
貓	猫
貗	𫎌
貙	䝙
貝	贝
貞	贞
貟	贠
負	负
財	财
貢	贡
貧	贫
貨	货
販	贩
貪	贪
貫	贯
責	责
貯	贮
貰	贳
貱	𬥶
貲	赀
貳	贰
貴	贵
貶	贬
買	买 𧹒
貸	贷
貺	贶
費	费
貼	贴
貽	贻
貿	贸
賀	贺
賁	贲
賂	赂
賃	赁
賄	贿
賅	赅
資	资
賈	贾
賊	贼
賑	赈
賒	赊
賓	宾
賕	赇
賗	𬥸
賙	赒
賚	赉
賜	赐
賝	𫎩
賞	赏
賟	𧹖
賠	赔
賡	赓
賢	贤
賣	卖
賤	贱
賦	赋
賧	赕
質	质
賫	赍
賬	账
賭	赌
賰	䞐
賴	赖
賵	赗
賶	𬥳
賸	剩 𬂉
賺	赚
賻	赙
購	购
賽	赛
賾	赜
贂	𬥞
贃	𧹗
贄	贽
贅	赘
贇	赟
贈	赠
贉	𫎫
贊	赞
贋	赝
贍	赡
贏	赢
贐	赆
贑	𫎬
贓	赃
贔	赑
贕	𫧿
贖	赎
贗	赝
贚	𫎦
贛	赣
贜	赃
赬	赪
趕	赶
趙	赵
趨	趋
趲	趱
跡	迹
跼	局
踐	践
踚	𬦧
踰	逾
踴	踊
蹌	跄
蹔	𫏐
蹕	跸
蹟	迹
蹠	跖
蹡	𬧀
蹣	蹒
蹤	踪
蹳	𫏆
蹺	跷
蹻	𫏋
躀	𬦻
躂	跶
躉	趸
躊	踌
躋	跻
躍	跃
躎	䟢
躑	踯
躒	跞
躓	踬
躕	蹰
躘	𨀁
躚	跹
躝	𨅬
躡	蹑
躥	蹿
躦	躜
躪	躏
軀	躯
軂	𬧤
軇	𮜶
軉	𨉗
車	车
軋	轧
軌	轨
軍	军
軏	𫐄
軑	轪
軒	轩
軔	轫
軕	𫐅
軗	𨐅
軛	轭
軜	𫐇
軝	𬨂
軞	𬨁
軟	软
軤	轷
軨	𫐉
軫	轸
軬	𫐊
軮	𬨄
軱	𮝴
軲	轱
軷	𫐈
軸	轴
軹	轵
軺	轺
軻	轲
軼	轶
軾	轼
軿	𫐌
輀	𮝵
較	较
輄	𨐈
輅	辂
輆	𬨇
輇	辁
輈	辀
載	载
輊	轾
輋	𪨶
輒	辄
輓	挽 𬨈
輔	辅
輕	轻
輖	𫐏
輗	𫐐
輛	辆
輜	辎
輝	辉
輞	辋
輟	辍
輢	𫐎
輥	辊
輦	辇
輨	𫐑
輩	辈
輪	轮
輬	辌
輮	𫐓
輯	辑
輳	辏
輴	𮝸
輵	𬨍
輶	𬨎
輷	𫐒
輸	输
輻	辐
輼	辒
輾	辗
輿	舆
轀	辒
轂	毂
轄	辖
轅	辕
轆	辘
轇	𫐖
轈	𬨓
轉	转
轊	𫐕
轍	辙
轎	轿
轐	𫐗
轒	𮝷
轔	辚
轕	𮝺
轗	𫐘
轘	𮝹
轝	𬛼
轟	轰
轠	𫐙
轡	辔
轢	轹
轣	𫐆
轤	轳
辦	办
辭	辞
辮	辫
辯	辩
農	农
迴	回
迺	乃
逕	迳
這	这
連	连
週	周
進	进
遊	游
運	运
過	过
達	达
違	违
遙	遥
遜	逊
遞	递
遠	远
遡	溯
適	适
遱	𫐷
遲	迟
遷	迁
選	选
遺	遗
遼	辽
邁	迈
還	还
邇	迩
邊	边
邏	逻
邐	逦
郟	郏
郲	𬩾
郵	邮
鄆	郓
鄉	乡
鄒	邹
鄔	邬
鄖	郧
鄟	𫑘
鄧	邓
鄩	𬩽
鄭	郑
鄮	𬪍
鄰	邻
鄲	郸
鄳	𫑡
鄴	邺
鄶	郐
鄺	邝
鄽	𫑮
酇	酂
酈	郦
醃	腌
醆	𬪨
醖	酝
醜	丑
醞	酝
醟	蒏
醣	糖
醦	𮠳
醧	𬪧
醫	医
醬	酱
醯	酰
醱	酦
醲	𬪩
醶	𫑷
醼	燕
釀	酿
釁	衅
釃	酾
釅	酽
釋	释
釐	厘
釒	钅
釓	钆
釔	钇
釕	钌
釗	钊
釘	钉
釙	钋
釚	𫟲
針	针
釟	𫓥
釣	钓
釤	钐
釦	扣 𬬪
釧	钏
釨	𫓦
釩	钒
釫	𬬨
釬	𬬧
釭	𮣲
釲	𫟳
釳	𨰿
釴	𬬩
釵	钗
釷	钍
釹	钕
釺	钎
釽	𬬲
釾	䥺
釿	𬬱
鈀	钯
鈁	钫
鈂	𬬵
鈃	钘
鈄	钭
鈅	钥
鈆	𫓪
鈇	𫓧
鈈	钚
鈉	钠
鈋	𨱂
鈍	钝
鈎	钩
鈐	钤
鈑	钣
鈒	钑
鈓	𬬯
鈔	钞
鈕	钮
鈖	𫟴
鈗	𫟵
鈚	𬬫
鈛	𫓨
鈜	𮣳
鈞	钧
鈠	𨱁
鈡	钟
鈣	钙
鈥	钬
鈦	钛
鈧	钪
鈮	铌
鈯	𨱄
鈰	铈
鈲	𨱃
鈳	钶
鈴	铃
鈶	𬭀
鈷	钴
鈸	钹
鈹	铍
鈺	钰
鈼	𬬽
鈽	钸
鈾	铀
鈿	钿
鉀	钾
鉁	𨱅
鉅	巨 钜
鉆	钻
鉈	铊
鉉	铉
鉊	𬬿
鉋	铇
鉍	铋
鉏	𬬺
鉐	𬬷
鉑	铂
鉔	𫓬
鉕	钷
鉗	钳
鉚	铆
鉛	铅
鉝	𫟷
鉞	钺
鉠	𫓭
鉢	钵
鉤	钩
鉥	𬬸
鉦	钲
鉧	𬭁
鉬	钼
鉭	钽
鉮	𬬹
鉳	锫
鉶	铏
鉷	𫟹
鉸	铰
鉺	铒
鉻	铬
鉽	𫟸
鉾	𫓴
鉿	铪
銀	银
銁	𫓲
銂	𫟻
銃	铳
銅	铜
銈	𫓯
銊	𫓰
銍	铚
銏	𫟶
銑	铣
銓	铨
銔	𬭃
銖	铢
銗	𬭅
銘	铭
銚	铫
銛	铦
銜	衔
銠	铑
銣	铷
銥	铱
銦	铟
銨	铵
銩	铥
銪	铕
銫	铯
銬	铐
銱	铞
銲	𬭍
銳	锐
銶	𨱇
銷	销
銹	锈
銻	锑
銼	锉
鋁	铝
鋂	镅
鋃	锒
鋄	𫓸
鋅	锌
鋇	钡
鋉	𨱈
鋋	𮣴
鋌	铤
鋏	铗
鋐	𬭎
鋒	锋
鋗	𫓶
鋘	𬭌
鋙	铻
鋝	锊
鋟	锓
鋠	𫓵
鋣	铘
鋤	锄
鋥	锃
鋦	锔
鋨	锇
鋩	铓
鋪	铺
鋭	锐
鋮	铖
鋯	锆
鋰	锂
鋱	铽
鋶	锍
鋸	锯
鋹	𬬮
鋼	钢
錀	𬬭
錁	锞
錂	𨱋
錄	录
錆	锖
錇	锫
錈	锩
錋	𬭖
錏	铔
錐	锥
錑	𬭜
錒	锕
錕	锟
錗	𬭗
錘	锤
錙	锱
錚	铮
錛	锛
錜	𫓻
錝	𫓽
錞	𬭚
錟	锬
錠	锭
錡	锜
錢	钱
錣	𮣵
錤	𫓹
錥	𫓾
錦	锦
錨	锚
錩	锠
錪	𬭓
錫	锡
錭	𬭕
錮	锢
錯	错
録	录
錳	锰
錶	表
錸	铼
錼	镎
錽	𫓸
鍀	锝
鍁	锨
鍃	锪
鍄	𨱉
鍅	钫
鍆	钔
鍇	锴
鍈	锳
鍉	𫔂
鍊	炼 链 𫔀
鍋	锅
鍍	镀
鍏	𬬬
鍒	𫔄
鍔	锷
鍘	铡
鍚	钖
鍛	锻
鍠	锽
鍣	𬭡
鍤	锸
鍥	锲
鍩	锘
鍬	锹
鍭	𬭤
鍮	𨱎
鍯	𬭥
鍰	锾
鍵	键
鍶	锶
鍺	锗
鍼	针
鍾	钟 锺
鎂	镁
鎄	锿
鎇	镅
鎈	𫟿
鎊	镑
鎋	𬭪
鎌	镰
鎍	𫔅
鎒	𬭦
鎓	𬭩
鎔	镕
鎖	锁
鎗	𬬰
鎘	镉
鎙	𫔈
鎚	锤 𬭨
鎛	镈
鎝	𨱏
鎞	𫔇
鎡	镃
鎢	钨
鎣	蓥
鎦	镏
鎧	铠
鎩	铩
鎪	锼
鎬	镐
鎭	镇
鎮	镇
鎯	𨱍
鎰	镒
鎲	镋
鎳	镍
鎵	镓
鎶	鿔
鎷	𨰾
鎸	镌
鎿	镎
鏁	𬭲
鏃	镞
鏆	𨱌
鏇	镟 旋
鏈	链
鏉	𨱒
鏌	镆
鏍	镙
鏏	𬭬
鏐	镠
鏑	镝
鏒	𬭝
鏔	𬭰
鏗	铿
鏘	锵
鏚	戚 𬭭
鏜	镗
鏝	镘
鏞	镛
鏟	铲
鏡	镜
鏢	镖
鏤	镂
鏥	𫔊
鏦	𫓩
鏨	錾
鏰	镚
鏵	铧
鏷	镤
鏹	镪
鏺	䥽
鏻	𬭸
鏽	锈
鏾	𫔌
鐀	𬭢
鐃	铙
鐄	𨱑
鐇	𫔍
鐈	𫓱
鐊	𬭏
鐋	铴
鐍	𫔎
鐎	𨱓
鐏	𨱔
鐐	镣
鐒	铹
鐓	镦
鐔	镡
鐗	锏
鐘	钟
鐙	镫
鐝	镢
鐠	镨
鐥	䦅
鐦	锎
鐧	锏
鐨	镄
鐩	𬭼
鐪	𫓺
鐫	镌
鐮	镰
鐯	䦃
鐲	镯
鐳	镭
鐴	𬭽
鐵	铁
鐶	镮
鐸	铎
鐺	铛
鐻	𮣷
鐼	𫔁
鐽	𫟼
鐿	镱
鑀	锿
鑄	铸
鑇	𬭉
鑉	𫠁
鑊	镬
鑌	镔
鑏	𬬾
鑑	鉴
鑒	鉴
鑔	镲
鑕	锧
鑙	𬭿
鑞	镴
鑠	铄
鑡	𬭔
鑢	𮣶
鑣	镳
鑥	镥
鑪	𬬻
鑭	镧
鑮	𬮁
鑰	钥
鑱	镵
鑲	镶
鑴	𫔔
鑷	镊
鑹	镩
鑼	锣
鑽	钻
鑾	銮
鑿	凿
钁	镢 䦆
钂	镋
镟	旋
長	长
門	门
閂	闩
閃	闪
閄	𬮘
閅	𮤫
閆	闫
閈	闬
閉	闭
開	开 𫔭
閌	闶
閍	𨸂
閎	闳
閏	闰
閐	𨸃
閑	闲
閒	闲 𫔮
間	间
閔	闵
閗	𫔯
閘	闸
閜	𬮠
閝	𫠂
閞	𫔰
閟	𮤲
閡	阂
閣	阁
閤	合 𬮤
閥	阀
閦	𬮥
閧	𬮢
閨	闺
閩	闽
閫	阃
閬	阆
閭	闾
閯	𬮪
閱	阅
閲	阅
閵	𫔴
閶	阊
閹	阉
閻	阎
閼	阏
閽	阍
閾	阈
閿	阌
闃	阒
闄	𬮲
闆	板 𬮳
闇	暗 𬮴
闈	闱
闉	𬮱
闊	阔
闋	阕
闌	阑
闍	阇
闐	阗
闑	𫔶
闒	阘
闓	闿
闔	阖
闕	阙
闖	闯
闚	𬮭
闞	阚
闠	阓
闡	阐
闢	辟
闤	阛
闥	闼
阪	阪 坂
陘	陉
陝	陕
陞	升
陣	阵
陰	阴
陳	陈
陸	陆
陽	阳
陿	𬯅
隉	陧
隊	队
階	阶
隑	𬮿
隕	陨
際	际
隝	𬮻
隤	𬯎
隨	随
險	险
隮	𬯀
隯	陦
隱	隐
隴	陇
隸	隶
隻	只
雋	隽
雖	虽
雙	双
雛	雏
雜	杂
雞	鸡
離	离
難	难
雲	云
電	电
霢	霡
霣	𫕥
霧	雾
霼	𪵣
霽	霁
靂	雳
靄	霭
靆	叇
靈	灵
靉	叆
靚	靓
靜	静
靝	靔
靦	腼 䩄
靧	𫖃
靨	靥
鞀	鼗
鞉	鼗
鞏	巩
鞝	绱
鞦	秋
鞽	鞒
鞾	𫖇
韁	缰
韃	鞑
韆	千
韉	鞯
韋	韦
韌	韧
韍	韨
韓	韩
韔	𮧴
韙	韪
韚	𫠅
韛	𫖔
韜	韬
韝	鞲 𫖕
韞	韫
韠	𫖒
韡	𮧵
韢	𬰶
韻	韵
響	响
頁	页
頂	顶
頃	顷
頄	𬱓
項	项
順	顺
頇	顸
須	须
頊	顼
頌	颂
頍	𫠆
頎	颀
頏	颃
預	预
頑	顽
頒	颁
頓	顿
頔	𬱖
頕	𬱗
頖	𬱙
頗	颇
領	领
頛	𬱜
頜	颌
頠	𬱟
頡	颉
頢	𬱠
頤	颐
頦	颏
頫	𫖯
頭	头
頮	颒
頰	颊
頲	颋
頴	颕
頵	𫖳
頷	颔
頸	颈
頹	颓
頻	频
頽	颓
顁	𬱫
顂	𩓋
顃	𩖖
顅	𫖶
顆	颗
顊	𬱪
題	题
額	额
顎	颚
顏	颜
顐	𬱢
顒	颙
顓	颛
顔	颜
顗	𫖮
願	愿 𫖸
顙	颡
顛	颠
類	类
顢	颟
顣	𫖹
顥	颢
顧	顾
顫	颤
顬	颥
顯	显
顰	颦
顱	颅
顳	颞
顴	颧
風	风
颭	飐
颮	飑
颯	飒
颰	𩙥
颱	台
颳	刮
颴	𬱽
颶	飓
颷	𩙪
颸	飔
颹	𬱵
颺	飏
颻	飖
颼	飕
颽	𬱼
颾	𩙫
颿	𬳳
飀	飗
飂	𮨵
飄	飘
飆	飙
飈	飚
飉	𬲅
飋	𫗋
飛	飞
飠	饣
飢	饥
飣	饤
飤	𬲦
飥	饦
飦	𫗞
飩	饨
飪	饪
飫	饫
飭	饬
飯	饭
飱	飧
飲	饮
飴	饴
飵	𫗢
飶	𫗣
飷	𬲭
飼	饲
飽	饱
飾	饰
飿	饳
餀	𮩜
餃	饺
餄	饸
餅	饼
餉	饷
養	养
餌	饵
餎	饹
餏	饻
餑	饽
餒	馁
餓	饿
餔	𫗦
餕	馂
餖	饾
餗	𫗧
餘	余 馀
餚	肴 𬳁
餛	馄
餜	馃
餞	饯
餟	𬳂
餡	馅
餣	𬲼
餦	𫗠
餧	𫗪
館	馆
餪	𫗬
餫	𫗥
餬	糊 𫗫
餭	𫗮
餰	𬳆
餱	糇 𫗯
餲	𮩝
餳	饧
餵	喂 𫗭
餶	馉
餷	馇
餸	𩠌
餹	𬳍
餺	馎
餼	饩
餾	馏
餿	馊
饀	𬳊
饁	馌
饃	馍
饅	馒
饆	𮩛
饈	馐
饉	馑
饊	馓
饋	馈
饌	馔
饐	𮩞
饑	饥
饒	饶
饗	飨
饘	𫗴
饜	餍
饞	馋
饟	𫗵
饠	𫗩
饢	馕
馩	𬳟
馬	马
馭	驭
馮	冯
馯	𫘛
馱	驮
馳	驰
馴	驯
馹	驲
馼	𫘜
駁	驳
駃	𫘝
駉	𬳶
駊	𫘟
駍	𬳴
駎	𩧨
駐	驻
駑	驽
駒	驹
駓	𬳵
駔	驵
駕	驾
駘	骀
駙	驸
駚	𩧫
駛	驶
駝	驼
駞	𫘞
駟	驷
駡	骂
駢	骈
駤	𫘠
駧	𩧲
駩	𩧴
駪	𬳽
駫	𫘡
駭	骇
駰	骃
駱	骆
駴	𮪢
駶	𩧺
駸	骎
駹	𮪡
駺	𬴀
駻	𫘣
駼	𬳿
駿	骏
騁	骋
騂	骍
騃	𫘤
騄	𫘧
騅	骓
騉	𫘥
騊	𫘦
騌	骔
騍	骒
騎	骑
騏	骐
騑	𬴂
騔	𩨀
騖	骛
騙	骗
騚	𩨊
騜	𫘩
騝	𩨃
騞	𬴃
騟	𩨈
騠	𫘨
騣	𮪣
騤	骙
騧	䯄
騪	𩨄
騫	骞
騭	骘
騮	骝
騯	𬴅
騰	腾
騱	𫘬
騲	𮪤
騴	𫘫
騵	𫘪
騶	驺
騷	骚
騸	骟
騹	𬴆
騻	𫘭
騼	𫠋
騾	骡
驀	蓦
驁	骜
驂	骖
驃	骠
驄	骢 𩨂
驅	驱
驊	骅
驋	𩧯
驌	骕
驍	骁
驎	𬴊
驏	骣
驐	𮪥
驓	𫘯
驕	骄
驖	𬴋
驗	验
驙	𫘰
驚	惊
驛	驿
驟	骤
驢	驴
驤	骧
驥	骥
驦	骦
驨	𫘱
驩	𬴐
驪	骊
驫	骉
骯	肮
髏	髅
髒	脏
體	体
髕	髌
髖	髋
髮	发
鬆	松
鬍	胡
鬖	𩭹
鬚	须
鬞	𬴩
鬠	𫘽
鬢	鬓
鬥	斗
鬦	𫔯
鬧	闹
鬨	哄
鬩	阋
鬮	阄
鬱	郁
鬹	鬶
魎	魉
魘	魇
魚	鱼
魛	鱽
魜	𬶁
魝	𬶀
魟	𫚉
魡	𬶄
魢	鱾
魣	𮬛
魥	𩽹
魦	𫚌
魨	鲀
魪	𬶇
魯	鲁
魴	鲂
魵	𫚍
魷	鱿
魺	鲄
魽	𫠐
鮀	𬶍
鮁	鲅
鮃	鲆
鮄	𫚒
鮅	𫚑
鮆	𫚖
鮈	𬶋
鮊	鲌
鮋	鲉
鮍	鲏
鮎	鲇
鮐	鲐
鮑	鲍
鮒	鲋
鮓	鲊
鮘	𬶌
鮚	鲒
鮜	鲘
鮝	鲞
鮞	鲕
鮟	𩽾
鮠	𬶏
鮡	𬶐
鮣	䲟
鮤	𫚓
鮦	鲖
鮨	𮬜
鮪	鲔
鮫	鲛
鮭	鲑
鮮	鲜
鮯	𫚗
鮰	𫚔
鮳	鲓
鮵	𫚛
鮶	鲪
鮷	𬶕
鮸	𩾃
鮺	鲝
鮿	𫚚
鯀	鲧
鯁	鲠
鯄	𩾁
鯆	𫚙
鯇	鲩
鯉	鲤
鯊	鲨
鯌	𬶔
鯒	鲬
鯔	鲻
鯕	鲯
鯖	鲭
鯗	鲞
鯛	鲷
鯝	鲴
鯞	𫚡
鯡	鲱
鯢	鲵
鯤	鲲
鯧	鲳
鯨	鲸
鯪	鲮
鯫	鲰
鯬	𫚞
鯰	鲶
鯱	𩾇
鯴	鲺
鯶	𩽼
鯷	鳀
鯹	𬶢
鯻	𬶟
鯽	鲫
鯾	𫚣
鯿	鳊
鰁	鳈
鰂	鲗
鰃	鳂
鰆	䲠
鰇	𬶧
鰈	鲽
鰉	鳇
鰊	𬶠
鰋	𫚢
鰌	䲡
鰍	鳅
鰏	鲾
鰐	鳄
鰑	𫚊
鰒	鳆
鰓	鳃
鰕	𫚥
鰗	𬶞
鰛	鳁
鰜	鳒
鰟	鳑
鰠	鳋
鰣	鲥
鰤	𫚕
鰥	鳏
鰦	𫚤
鰧	䲢
鰨	鳎
鰩	鳐
鰫	𫚦
鰭	鳍
鰮	鳁
鰱	鲢
鰲	鳌
鰳	鳓
鰵	鳘
鰶	𬶭
鰷	鲦
鰹	鲣
鰺	鲹
鰻	鳗
鰼	鳛
鰽	𫚧
鰾	鳔
鱀	𬶨
鱂	鳉
鱄	𫚋
鱅	鳙
鱆	𫠒
鱇	𩾌
鱈	鳕
鱉	鳖
鱊	𫚪
鱋	𬶬
鱌	𬶲
鱑	𬶫
鱒	鳟
鱓	𬶛
鱔	鳝
鱖	鳜
鱗	鳞
鱘	鲟
鱚	𬶮
鱝	鲼
鱞	𬶵
鱟	鲎
鱠	鲙
鱢	𫚫
鱣	鳣
鱤	鳡
鱥	𮬝
鱧	鳢
鱨	鲿
鱭	鲚
鱮	𫚈
鱯	鳠
鱲	𫚭
鱵	𮬤
鱷	鳄
鱸	鲈
鱹	𬶺
鱺	鲡
鳥	鸟
鳧	凫
鳩	鸠
鳬	凫
鳲	鸤
鳳	凤
鳴	鸣
鳶	鸢
鳷	𫛛
鳼	𪉃
鳽	𫛚
鳾	䴓
鴀	𫛜
鴁	𮭢
鴃	𫛞
鴅	𫛝
鴆	鸩
鴇	鸨
鴉	鸦
鴍	𬸀
鴐	𫛤
鴒	鸰
鴓	𮭤
鴔	𫛡
鴕	鸵
鴗	𫁡
鴛	鸳
鴜	𪉈
鴝	鸲
鴞	鸮
鴟	鸱
鴣	鸪
鴥	𫛣
鴦	鸯
鴨	鸭
鴮	𫛦
鴯	鸸
鴰	鸹
鴲	𪉆
鴳	𫛩
鴴	鸻
鴷	䴕
鴻	鸿
鴽	𫛪
鴿	鸽
鵀	𬸊
鵁	䴔
鵂	鸺
鵃	鸼
鵄	𬸈
鵊	𫛥
鵐	鹀
鵑	鹃
鵒	鹆
鵓	鹁
鵚	𪉍
鵜	鹈
鵝	鹅
鵟	𫛭
鵠	鹄
鵡	鹉
鵧	𫛨
鵩	𫛳
鵪	鹌
鵫	𫛱
鵬	鹏
鵮	鹐
鵯	鹎
鵰	雕 𫛲
鵲	鹊
鵷	鹓
鵾	鹍
鶀	𬸒
鶂	𬷼
鶄	䴖
鶇	鸫
鶉	鹑
鶊	鹒
鶌	𫛵
鶒	𫛶
鶓	鹋
鶕	𬸝
鶖	鹙
鶗	𫛸
鶘	鹕
鶚	鹗
鶠	𬸘
鶡	鹖
鶣	𬸜
鶥	鹛
鶦	𫛷
鶩	鹜
鶪	䴗
鶬	鸧
鶭	𫛯
鶯	莺
鶰	𫛫
鶱	𬸣
鶲	鹟
鶴	鹤
鶵	𬸅
鶹	鹠
鶺	鹡
鶻	鹘
鶼	鹣
鶿	鹚
鷀	鹚
鷁	鹢
鷂	鹞
鷃	𮭨
鷄	鸡
鷅	𫛽
鷇	𬆮
鷈	䴘
鷉	䴘
鷊	鹝
鷎	𬸢
鷐	𫜀
鷓	鹧
鷔	𪉑
鷖	鹥
鷗	鸥
鷙	鸷
鷚	鹨
鷜	𬸞
鷞	𮭪
鷟	𬸦
鷣	𫜃
鷤	𫛴
鷥	鸶
鷦	鹪
鷨	𪉊
鷩	𫜁
鷫	鹔
鷭	𬸪
鷯	鹩
鷰	𬸧
鷲	鹫
鷳	鹇
鷴	鹇
鷷	𫜄
鷸	鹬
鷹	鹰
鷺	鹭
鷼	鹇
鷽	鸴
鷿	䴙 𬸯
鸂	㶉
鸇	鹯
鸊	䴙
鸋	𫛢
鸌	鹱
鸎	𬸕
鸏	鹲
鸑	𬸚
鸕	鸬
鸖	𬸰
鸗	𫛟
鸘	鹴
鸚	鹦
鸛	鹳
鸜	𬸱
鸝	鹂
鸞	鸾
鹵	卤
鹹	咸
鹺	鹾
鹼	碱 硷
鹽	盐
麗	丽
麥	麦
麨	𪎊
麩	麸
麪	面 𮮄
麫	面
麬	𤿲
麭	𮮆
麯	曲
麰	𮮇
麲	𪎉
麳	𪎌
麴	曲 麹
麵	面 麺
麷	𫜑
麼	么 麽
麽	么 麽
黃	黄
黌	黉
黏	粘
點	点
黨	党
黲	黪
黴	霉
黶	黡
黷	黩
黽	黾
黿	鼋
鼂	鼌
鼇	鳌
鼉	鼍
鼕	冬
鼴	鼹
齇	齄
齊	齐
齋	斋
齎	赍
齏	齑
齒	齿
齔	龀
齕	龁
齖	𬹺
齗	龂
齘	𬹼
齙	龅
齜	龇
齟	龃
齠	龆
齡	龄
齣	出
齦	龈
齧	啮 𫜩
齩	𫜪
齪	龊
齬	龉
齭	𫜭
齮	𬺈
齯	𫠜
齰	𫜬
齲	龋
齴	𫜮
齶	腭
齷	龌
齹	𬺎
齼	𬺓
齽	𬺔
齾	𫜰
龍	龙
龎	厐
龐	庞
龑	䶮
龓	𫜲
龔	龚
龕	龛
龜	龟
龝	𬓫
龥	𬱳
龭	𩨎
龯	𨱆
鿁	䜤
鿓	鿒
𠁞	𠀾
𠌥	𠆿
𠎒	𫢨
𠏍	𪝘
𠏢	𠉗
𠐊	𫝋
𠐍	𫣫
𠐮	𬾣
𠑙	𫢹
𠑲	𫣛
𠒺	𪨇
𠖫	𫤽
𠗣	㓆
𠘥	𫥍
𠜲	𫥼
𠝿	𫦁
𠞆	𠛆
𠞭	𫦉
𠟪	𫥺
𠠎	𠚳
𠠏	𫥵
𠠝	𫥳
𠤩	𬙞
𠬙	𪠡
𠵹	𫩚
𠹛	𫩯
𠺮	𫪅
𠼗	𫪚
𠼤	𫪄
𠼮	𫩳
𠽃	𪠺
𠽈	𭈟
𠽸	𬱞
𠾬	𫪽
𠿕	𪜎
𡀿	𫫵
𡂒	𫪪
𡂡	𪢒
𡂿	𫪘
𡃄	𪡺
𡃕	𠴛
𡃤	𪢐
𡄔	𠴢
𡄖	𭈉
𡄣	𠵸
𡅏	𠲥
𡅥	𫬟
𡅧	𭉼
𡅯	𪢖
𡍫	𫭮
𡑍	𫭼
𡑎	𫭯
𡑭	𡋗
𡓁	𪤄
𡓾	𡋀
𡔖	𡍣
𡝵	𫰓
𡞵	㛟
𡟫	𫝪
𡠹	㛿
𡡎	𡞱
𡢃	㛠
𡢿	𭑸
𡤠	𫰣
𡤫	𫱿
𡮉	𡭜
𡮣	𡭬
𡮤	𫴼
𡳳	𡳃
𡷨	𫵸
𡸗	𪨩
𡹬	𪨹
𡺨	𫵶
𡻕	岁
𡽗	𡸃
𡽳	𫶊
𡽵	𫵹
𡾱	㟜
𡿖	𪩛
𢍰	𪪴
𢛔	𫹼
𢠼	𢙑
𢢀	𫺒
𢣐	𪬚
𢣚	𢘝
𢣭	𢘞
𢤜	𫺫
𢤞	𪬡
𢤩	𪫡
𢤱	𢘙
𢤿	𪬯
𢥠	𫹷
𢭯	𪭱
𢯦	𫼲
𢯩	𫼤
𢯷	𪭝
𢱡	𫼶
𢲩	𫼾
𢲫	𫼗
𢲸	𫼵
𢲾	𫼫
𢳂	𫼣
𢳚	𫽐
𢴦	𫽙
𢵣	𭡵
𢶑	𫽲
𢶒	𪭯
𢶢	𪭮
𢶫	𢫞
𢷞	𭢕
𢷬	𢭏
𢷮	𢫊
𢸙	𭡜
𢸳	𫾃
𢸴	𫾁
𢹿	𢬦
𢺥	𫽕
𢺳	𪮳
𣀘	𫾳
𣀷	𫾲
𣄸	𬀥
𣈶	暅
𣋋	𣈣
𣌂	𬁑
𣍐	𫧃
𣙆	𭪱
𣙎	㭣
𣙿	𬃮
𣛣	𬂻
𣜬	𪳗
𣝕	𣘷
𣞻	𣘓
𣠩	𣞎
𣠲	𣑶
𣡌	𬄬
𣤿	𬶷
𣫒	𫶲
𣯩	𣯣
𣯴	𣭤
𣯶	毶
𣻑	𭰒
𣼊	𭰗
𣽏	𪶮
𣾷	㳢
𣿉	𣶫
𤀪	𬈱
𤁣	𣺽
𤁪	𬈾
𤄖	𭰏
𤄬	𭰥
𤄷	𪶒
𤅈	𭲴
𤅙	𬇬
𤅶	𣷷
𤍖	𬊗
𤎤	𬝃
𤏐	𭴳
𤐴	𬊭
𤑳	𤎻
𤑹	𪹀
𤒎	𤊀
𤒘	𬊯
𤒦	𬋃
𤒻	𪹹
𤓌	𪹠
𤓩	𤊰
𤘀	𪺣
𤛠	𬌥
𤛮	𤙯
𤛱	𫞢
𤜆	𪺪
𤠮	𪺸
𤢟	𤝢
𤢻	𢢐
𤣤	𬌴
𤩂	𫞧
𤪥	𬍜
𤪺	㻘
𤫩	㻏
𤬅	𪼴
𤲓	𭻔
𤳷	𪽝
𤳸	𤳄
𤷃	𪽭
𤸫	𤶧
𤺔	𪽴
𤻲	𬏤
𥊝	𥅿
𥌃	𥅘
𥌚	𬑙
𥏝	𪿊
𥕥	𥐰
𥖅	𥐯
𥖏	𮀪
𥖩	𬒊
𥖲	𪿞
𥗇	𪿵
𥗑	𬒈
𥗴	𬒓
𥗺	𬒇
𥗽	𬒗
𥘃	𮀡
𥜐	𫀓
𥜰	𫀌
𥞵	𥞦
𥢊	𬓱
𥢢	䅪
𥢶	𫞷
𥢷	𫀮
𥣻	𦼖
𥨐	𥧂
𥪂	𥩺
𥯤	𫁳
𥱸	𬔯
𥴨	𫂖
𥴼	𫁺
𥵃	𥱔
𥵊	𥭉
𥶽	𫁱
𥸠	𥮋
𥻤	𬖖
𥻦	𫂿
𥻵	𬖞
𥼶	𬖘
𥼽	𥹥
𥽖	𥺇
𥽭	𬖺
𥾂	𮇤
𥾝	𬘔
𥾯	𫄝
𥿉	𬘚
𥿊	𦈈
𥿯	𬘦
𦀎	𮉥
𦀖	𫄦
𦂅	𦈒
𦂋	𬘸
𦃄	𦈗
𦃒	𬘼
𦃘	𬘽
𦃩	𫄯
𦃪	𬘗
𦄋	𬘞
𦄍	𬘾
𦄧	𬘿
𦄼	𬘳
𦅇	𫄪
𦅈	𫄵
𦅋	𬙃
𦅷	𬙅
𦆲	𫟇
𦆹	𬗔
𦒀	𫅥
𦔖	𫅼
𦘧	𡳒
𦜖	𬁺
𦞛	𬁸
𦟐	𬁳
𦟼	𫆝
𦠅	𫞅
𦡝	𫆫
𦡧	𮌌
𦢈	𣍨
𦣇	𬂂
𦣎	𦟗
𦧺	𫇘
𦪙	䑽
𦪽	𦨩
𦱌	𫇪
𦶆	𬜺
𦸷	𬝊
𦽒	𬝠
𦾟	𦶻
𦾶	𬞋
𧀜	𬞨
𧁿	𮏺
𧂅	𬞣
𧅤	𬝄
𧅰	𫉚
𧍴	𬟾
𧎈	𧌥
𧎵	𫊨
𧏺	𮓹
𧏻	𬠃
𧐱	𬟺
𧒯	𫊹
𧔥	𧒭
𧕟	𧉐
𧕦	𬠷
𧛸	𬡎
𧜁	𬡕
𧜂	𬡔
𧜗	䘞
𧜣	𬡍
𧜵	䙊
𧜶	𮖃
𧝞	䘛
𧞫	𫌋
𧞶	𬡦
𧟀	𧝧
𧟌	𬡠
𧠈	𬢇
𧠊	𫤸
𧠵	𬢉
𧡍	𬢈
𧡪	𬢏
𧡴	𫌫
𧢄	𫌬
𧢍	𬢓
𧢢	𬺟
𧣴	𬢕
𧥣	𬣚
𧥺	𬣝
𧦝	𫍞
𧦧	𫍟
𧦭	𬣢
𧧝	𬣨
𧧭	𬣺
𧨊	𬣶
𧨾	𬤂
𧩕	𫍭
𧩙	䜥
𧩦	𬤅
𧩧	𬤏
𧩪	𬤋
𧩼	𫍶
𧪞	𬤒
𧪡	𬤓
𧪦	𬤕
𧪪	𬤔
𧫚	𬤈
𧫝	𫍺
𧬅	𬤜
𧬇	𬤞
𧬌	𬤠
𧬤	𫍼
𧬨	𬣪
𧬪	𬤖
𧬮	𬤧
𧬻	𬣵
𧭈	𫍾
𧭹	𫍐
𧮆	𬤚
𧮇	𬣴
𧮈	𬤯
𧮓	𬤱
𧰆	𬤷
𧳟	𧳕
𧴪	𭕆
𧵊	𬥴
𧵳	䞌
𧶄	𬥷
𧶔	𧹓
𧶟	𬥹
𧶧	䞎
𧶲	𬥼
𧷎	𪠀
𧸘	𫎨
𧸦	𬥾
𧸪	𬥿
𧸫	𫬙
𧹈	𪥠
𧼮	𬦅
𧽢	𬦆
𧽤	𫎲
𧽯	𫎸
𨁂	𬦯
𨂐	𫏌
𨃘	𬦩
𨃜	𬦹
𨄣	𨀱
𨄰	𬦵
𨅍	𨁴
𨆅	𬦫
𨆉	𮛗
𨆪	𫏕
𨇁	𧿈
𨇍	𬧑
𨇗	𬦣
𨇞	𨅫
𨇤	𫏨
𨇰	𫏞
𨇽	𫏑
𨈀	𬧚
𨈆	𮛔
𨈇	𬦾
𨈊	𨂺
𨈌	𨄄
𨉹	𬧩
𨊰	䢀
𨊸	䢁
𨊻	𨐆
𨋁	𬨃
𨋚	𬨅
𨋢	䢂
𨌄	𬨋
𨌈	𫐍
𨍐	𬨏
𨍰	𫐔
𨍹	𬨐
𨎌	𫐋
𨎩	𬨒
𨎮	𨐉
𨏠	𨐇
𨏡	𬨕
𨏥	𨐊
𨘌	𬩎
𨞺	𫟫
𨟊	𫟬
𨢿	𨡙
𨣈	𨡺
𨣉	𬪫
𨣞	𨟳
𨣧	𨠨
𨤋	𬪯
𨤡	𬪺
𨤻	𨤰
𨥛	𨱀
𨥜	𬬴
𨥟	𫓫
𨥦	𬬳
𨥺	𬭂
𨦫	䦀
𨧀	𬭊
𨧚	𬭐
𨧜	䦁
𨧫	𬭑
𨧰	𫟽
𨧱	𨱊
𨨏	𬭛
𨨛	𫓼
𨨝	𬭘
𨨢	𫓿
𨨯	𬭟
𨨹	𬭞
𨩨	𬭠
𨩰	𫟾
𨪕	𫓮
𨪵	𬭧
𨫀	𬭫
𨫒	𨱐
𨬂	𬭱
𨬖	𫔏
𨬞	𬬶
𨭃	𬭷
𨭆	𬭶
𨭊	𬭒
𨭌	𬭵
𨭎	𬭳
𨭐	𬭙
𨭖	𫔑
𨭗	𬭇
𨭚	𬭺
𨭥	𬬼
𨭸	𫔐
𨮂	𨱕
𨮅	𬭹
𨮰	𬭾
𨮳	𫔒
𨯅	䥿
𨯗	𮢽
𨯟	𫔓
𨯵	𬮀
𨰃	𫔉
𨰋	𫓳
𨰥	𫔕
𨰭	𬮃
𨰲	𫔃
𨰷	𬮂
𨲳	𫔖
𨳑	𨸁
𨳒	𮤭
𨳕	𨸀
𨳙	𮤯
𨳨	𬮜
𨳿	𬮡
𨴑	𬮣
𨴗	𨸅
𨴤	𬮧
𨴹	𫔲
𨵆	𬮩
𨵌	𬮰
𨵗	𬮯
𨵤	𬮮
𨵩	𨸆
𨵬	𬮵
𨵸	𨸇
𨶀	𨸉
𨶏	𨸊
𨶮	𨸌
𨶯	𮤸
𨶲	𨸋
𨶻	𬮸
𨶿	𬮹
𨷈	𬮙
𨷯	𬮷
𨷲	𨸎
𨷶	𫔸
𨼳	𫔽
𨽏	𨸘
𩀨	𫕚
𩅙	𫕨
𩇉	𮦚
𩉙	𬰡
𩋰	𬰤
𩎒	𬰱
𩎖	𫖑
𩎠	𬰴
𩎢	𩏾
𩏂	𫖓
𩏌	𬰵
𩏠	𫖖
𩏪	𩏽
𩏴	𬰸
𩏷	𫃗
𩑃	𬰺
𩑔	𫖪
𩑣	𬱔
𩑦	𬱕
𩒎	𫖭
𩒜	𬱡
𩒝	𬱝
𩒲	𬱤
𩒼	𬱥
𩓣	𩖕
𩓥	𫖵
𩓸	𬱧
𩓹	𬱨
𩔈	𬱭
𩔊	𬱛
𩔑	𫖷
𩔳	𫖴
𩕊	𬱱
𩖁	𬺂
𩖰	𫠇
𩖿	𬱺
𩗀	𩙦
𩗓	𫗈
𩗡	𩙧
𩗴	𫗉
𩘀	𩙩
𩘚	𬰲
𩘝	𩙭
𩘹	𩙨
𩘺	𩙬
𩘻	𬲆
𩙈	𩙰
𩚅	𬲥
𩚚	𬲩
𩚛	𩟿
𩚥	𩠀
𩚩	𫗡
𩚵	𩠁
𩛆	𩠂
𩛌	𫗤
𩛎	𬲴
𩛞	𬲺
𩛡	𫗨
𩛩	𩠃
𩛲	𬲹
𩜇	𩠉
𩜠	𬲿
𩜦	𩠆
𩜰	𬳃
𩜵	𩠊
𩝑	𬳇
𩝔	𩠋
𩝠	𬳌
𩝡	𬳈
𩝣	𬳉
𩝽	𫗳
𩞃	𬲰
𩞄	𩠎
𩞆	𬲪
𩞉	𬳐
𩞡	𬲬
𩞦	𩠏
𩞬	𬳒
𩞯	䭪
𩟀	𬳓
𩟂	𬲸
𩟐	𩠅
𩟗	𫗚
𩟠	𬳔
𩠴	𩠠
𩡣	𩡖
𩡺	𩧦
𩢍	𬳷
𩢡	𩧬
𩢲	𬳺
𩢴	𩧵
𩢸	𩧳
𩢼	𬳻
𩢾	𩧮
𩣋	𬳼
𩣏	𩧶
𩣑	䯃
𩣔	𬳹
𩣫	𩧸
𩣵	𩧻
𩣺	𩧼
𩤊	𩧩
𩤙	𩨆
𩤲	𩨉
𩤵	𬴄
𩤸	𩨅
𩥄	𩨋
𩥇	𩨍
𩥉	𩧱
𩥑	𩨌
𩥲	𬴇
𩥼	𬴈
𩦚	𬴉
𩦠	𫠌
𩦺	𬴌
𩧆	𩨐
𩧐	𬴎
𩭙	𩬣
𩯁	𫙂
𩯆	𬴨
𩯳	𩯒
𩰀	𩬤
𩰹	𩰰
𩳤	𩲒
𩴵	𩴌
𩵚	𬶂
𩵦	𫠏
𩵩	𩽺
𩵱	𬶉
𩵹	𩽻
𩵺	𬶈
𩶀	𬶅
𩶁	𫚎
𩶘	䲞
𩶰	𩽿
𩶱	𩽽
𩷒	𬶒
𩷰	𩾄
𩸃	𩾅
𩸄	𫚝
𩸆	𬶖
𩸡	𫚟
𩸣	𬶙
𩸤	𬶚
𩸦	𩾆
𩸩	𬶝
𩸬	𬶜
𩹊	𬶦
𩹝	𬶡
𩹡	𬶘
𩹽	𬶩
𩺝	𬶪
𩻗	𫚨
𩻧	𬶯
𩻬	𫚩
𩻮	𫚘
𩻰	𬶰
𩻱	𬶱
𩼔	𬶶
𩼶	𫚬
𩽅	𬶸
𩽇	𩾎
𩽈	𬶳
𩽔	𬶹
𩽷	𬶻
𩾐	𬷻
𩾒	𬷽
𩿅	𫠖
𩿤	𫛠
𩿪	𪉄
𩿱	𬸃
𩿺	𬸁
𪀉	𬸂
𪀖	𫛧
𪀛	𬸉
𪀦	𪉅
𪀻	𬸋
𪀾	𪉋
𪁈	𪉉
𪁏	𮭦
𪁐	𬸎
𪁑	𬸑
𪁖	𪉌
𪁜	𬸏
𪁱	𬸐
𪁿	𬸔
𪂆	𪉎
𪂈	𬸖
𪂩	𬸗
𪂫	𬸓
𪃍	𪉐
𪃏	𪉏
𪃒	𫛻
𪃦	𬸙
𪃧	𫛹
𪃮	𬸟
𪃿	𬸠
𪄅	𬸌
𪄆	𪉔
𪄕	𪉒
𪅂	𫜂
𪅃	𬸤
𪅖	𬸥
𪅜	𬷿
𪅾	𬸨
𪆃	𬸫
𪆰	𬸭
𪆴	𬸮
𪆷	𫛾
𪇄	𬸬
𪇖	𬸡
𪇘	𬸍
𪇳	𪉕
𪈗	𬸄
𪈰	𮬽
𪈼	𪉓
𪉜	𬸵
𪉨	𬸶
𪉮	𬸷
𪉱	𬸸
𪉸	𫜊
𪉿	𬸹
𪋿	𫧮
𪌒	𮮅
𪌜	𪽂
𪌞	𬍞
𪌭	𫜓
𪌯	𬹈
𪌰	𬹇
𪌽	𬹋
𪌿	𬹌
𪍀	𬹊
𪍠	𫜕
𪍤	𬹍
𪍶	𬹎
𪑚	𬹗
𪑳	𬹕
𪒬	𬹖
𪒿	𬹘
𪓰	𫜟
𪓽	𬹤
𪔵	𪔭
𪕣	𬹭
𪗜	𬹽
𪗝	𬹻
𪗪	𬹿
𪗭	𬺀
𪗳	𬹾
𪗻	𬺁
𪗽	𬺄
𪘀	𪚏
𪘓	𬺇
𪘞	𬺆
𪘧	𬺋
𪘩	𬺊
𪘯	𪚐
𪘲	𬺌
𪙍	𬺏
𪙏	𫜯
𪙑	𬺑
𪙕	𬺐
𪙞	𬺅
𪙤	𬺒
𪚅	𬺖
𪚔	𬺛
𪚣	𬺝
𪝖	𫢟
𪟖	𠛾
𪢥	𫩸
𪮰	𫼽
𪯂	𭡆
𪳷	𬂱
𪴥	𬃏
𪷈	𭱀
𪷓	𣶭
𫁘	𮄅
𫃐	𬖟
𫃥	𮉩
𫃷	𮉭
𫄇	𬘹
𫄎	𫄄
𫉍	𮏀
𫋐	𬠈
𫌙	𬡱
𫍘	𫍏
𫒞	𬭋
𫒡	𫓷
𫖞	𬱘
𫗑	𬲵
𫗕	𬳄
𫜦	𫜫
𫣴	𫢲
𫥝	𫥔
𫦔	𫦋
𫦙	𫥽
𫦸	𫦰
𫧝	𪟲
𫨑	𪠃
𫬆	𫫏
𫶦	𫶄
𫻑	𫺹
𫽨	𫼭
𬀛	𪯼
𬄝	𬃛
𬆉	𬆂
𬉤	𬈏
𬍁	𬌵
𬒒	𬒄
𬗏	𬘣
𬗺	𬙀
𬙔	𬙏
𬣍	𬣫
𬣘	𬤗
𬥲	𬦀
𬧙	𬧔
𬮇	𬮝
𬮍	𮤷
𬯘	𬯊
𬱂	𬱚
𬱈	𬱩
𬲚	𬳎
𬵃	𬶃
𬵮	𬶑
𬹂	𬹆
𭀷	𭀳
𭑙	𮤮
𭒨	𫲄
𭢌	𪮅
𭳯	𭲍
𭷁	𭣣
𮝄	𮝳
𮤏	𮤳
𮤒	𬮬
𮦗	𮦅
𮨭	𬱾
𮨻	𬲱
𮬭	𮭣
