0余	0餘
0天	0天
0天后	0天後
0寸	0吋
0海	0海
0海里	0海里
0里	0里
1天	1天
1天后	1天後
1寸	1吋
1海	1海
1海里	1海里
1里	1里
2天	2天
2天后	2天後
2寸	2吋
2海	2海
2海里	2海里
2里	2里
3天	3天
3天后	3天後
3寸	3吋
3海	3海
3海里	3海里
3里	3里
4天	4天
4天后	4天後
4寸	4吋
4海	4海
4海里	4海里
4里	4里
5天	5天
5天后	5天後
5寸	5吋
5海	5海
5海里	5海里
5里	5里
6天	6天
6天后	6天後
6寸	6吋
6海	6海
6海里	6海里
6里	6里
7天	7天
7天后	7天後
7寸	7吋
7海	7海
7海里	7海里
7里	7里
8天	8天
8天后	8天後
8寸	8吋
8海	8海
8海里	8海里
8里	8里
9天	9天
9天后	9天後
9寸	9吋
9海	9海
9海里	9海里
9里	9里
A’	A'
B’	B'
C’	C'
D’	D'
E’	E'
F’	F'
G’	G'
H’	H'
I’	I'
J’	J'
K’	K'
L’	L'
M’	M'
N’	N'
O’	O'
P’	P'
Q’	Q'
R’	R'
S’	S'
T’	T'
U’	U'
V’	V'
W’	W'
X’	X'
Y’	Y'
Z’	Z'
a’	a'
b’	b'
c’	c'
d’	d'
e’	e'
f’	f'
g’	g'
h’	h'
i’	i'
j’	j'
k’	k'
l’	l'
m’	m'
n’	n'
o’	o'
p’	p'
q’	q'
r’	r'
s’	s'
t’	t'
u’	u'
v’	v'
w’	w'
x’	x'
y’	y'
z’	z'
○余	○餘
○海	○海
○海里	○海里
○里	○里
“恩	「嗯
“恩！	「嗯！
“当	「當
“当”	「噹」
“当！	「噹！
一并	一併
一并不	一並不
一并且	一並且
一并非	一並非
一伙	一夥
一个	一個
一出	一出
一出京剧	一齣京劇
一出剧	一齣劇
一出剧院	一出劇院
一出好戏	一齣好戲
一出戏	一齣戲
一出话剧	一齣話劇
一出电影	一齣電影
一制	一制
一制作	一製作
一制程	一製程
一制药	一製藥
一只	一隻
一只只	一隻隻
一只只够	一隻只夠
一只只有	一隻只有
一周	一週
一大	一大
一大伙	一大夥
一天	一天
一天后	一天後
一干	一干
一干二净	一乾二淨
一干就	一幹就
一干而尽	一乾而盡
一斗	一斗
一斗不	一鬥不
一斗再斗	一鬥再鬥
一松	一鬆
一松林	一松林
一松树	一松樹
一松鼠	一松鼠
一树	一樹
一树百获	一樹百穫
一毫	一毫
一毫一发	一毫一髮
一冲	一沖
一冲一撞	一衝一撞
一海	一海
一海里	一海里
一涂	一塗
一游	一遊
一物	一物
一物克一	一物剋一
一发	一發
一发之差	一髮之差
一发之间	一髮之間
一发千钧	一髮千鈞
一直	一直
一直干	一直幹
一直发女	一直髮女
一箭	一箭
一箭双雕	一箭雙鵰
一般	一般
一般只	一般只
一里	一里
一里余	一里餘
一赞	一讚
一锅	一鍋
一锅面	一鍋麵
一面	一面
一点	一點
一点丑	一點醜
丁当	叮噹
丁铃	叮鈴
七只	七隻
七天	七天
七天后	七天後
七海	七海
七海里	七海里
七海里面	七海裡面
七里	七里
七里余	七里餘
七面	七面
丈余	丈餘
三个	三個
三只	三隻
三周	三週
三叹	三歎
三国	三國
三国志	三國志
三天	三天
三海	三海
三海里	三海里
三里	三里
三里余	三里餘
三丰	三丰
上准	上準
上周	上週
上布	上佈
上折	上摺
上梁	上樑
上梁山	上梁山
上冲	上衝
上冲刷	上沖刷
上冲水	上沖水
上冲洗	上沖洗
上冲凉	上沖涼
上冲澡	上沖澡
上签	上籤
下台	下台
下咽	下嚥
下摆	下襬
下梁	下樑
下冲	下衝
下签	下籤
下里	下里
不丑	不醜
不并	不併
不余	不餘
不修	不修
不修篇幅	不修邊幅
不值	不值
不值一晒	不值一哂
不大	不大
不大象	不大像
不寒	不寒
不寒而栗	不寒而慄
不干	不干
不干不净	不乾不淨
不干他	不干他
不干休	不干休
不干你	不干你
不干她	不干她
不干我	不干我
不干扰	不干擾
不干政	不干政
不干杯	不乾杯
不干涉	不干涉
不干净	不乾淨
不干系	不干係
不干脆	不乾脆
不乾着急	不乾著急
不干裂	不乾裂
不干预	不干預
不愈	不癒
不斗	不鬥
不断	不斷
不断发展	不斷發展
不方	不方
不方便	不方便
不松	不松
不松下	不鬆下
不涂	不塗
不当	不當
不当准	不當準
不系	不繫
不能	不能
不能干	不能干
不能象	不能象
不能象征	不能象徵
不舍	不捨
不要	不要
不要干	不要干
不要象	不要象
不象	不像
不赞	不讚
不采	不採
丑一	丑一
丑一点	醜一點
丑不	丑不
丑不丑	醜不醜
丑丑	醜醜
丑丫	丑丫
丑丫头	醜丫頭
丑丫鬟	醜丫鬟
丑也	丑也
丑也丑	醜也醜
丑事	醜事
丑人	醜人
丑似	醜似
丑俊	醜俊
丑八	丑八
丑八怪	醜八怪
丑八戒	醜八戒
丑剧	醜劇
丑化	醜化
丑名	醜名
丑女	醜女
丑如	醜如
丑婆	醜婆
丑妇	醜婦
丑媳	丑媳
丑媳妇	醜媳婦
丑家	丑家
丑家伙	醜傢伙
丑小	丑小
丑小子	醜小子
丑小鸭	醜小鴨
丑少	丑少
丑少年	醜少年
丑巴	丑巴
丑巴怪	醜巴怪
丑得	醜得
丑得象	醜得像
丑怪	醜怪
丑恶	醜惡
丑态	醜態
丑东	丑東
丑东西	醜東西
丑模	丑模
丑模样	醜模樣
丑样	醜樣
丑死	醜死
丑汉	醜漢
丑煞	丑煞
丑煞人	醜煞人
丑男	醜男
丑的	醜的
丑老	醜老
丑老头	醜老頭
丑闻	醜聞
丑声	醜聲
丑脸	醜臉
丑行	醜行
丑诋	醜詆
丑话	醜話
丑语	醜語
丑貌	醜貌
丑陋	醜陋
丑面	醜面
丑类	醜類
丑鬼	醜鬼
且斗	且斗
且斗且	且鬥且
世界	世界
世界杯	世界盃
丢丑	丟醜
丢了	丟了
丢了丑	丟了醜
并不	並不
并不并	併不併
并入	併入
并力	併力
并包	并包
并合	併合
并吞	併吞
并图	併圖
并拢	併攏
并案	併案
并叠	併疊
并发	並發
并发症	併發症
并砌	併砌
并科	併科
并肩	並肩
并肩子	併肩子
并肩干	並肩幹
并负	併負
并负责	並負責
并购	併購
并购买	並購買
并赃	併贓
并赃拿贼	併贓拿賊
并赃治罪	併贓治罪
并采	並採
并除	併除
并陇	併攏
中仑	中崙
中岳	中嶽
中布	中佈
中签	中籤
主干	主幹
久斗	久鬥
之余	之餘
之准	之準
之欲	之慾
之游	之遊
九只	九隻
九叹	九歎
九天	九天
九天后	九天後
九海	九海
九海里	九海里
九里	九里
九里余	九里餘
九面	九面
也没	也沒
也没干	也沒幹
也舍	也舍
也舍下	也捨下
也舍弃	也捨棄
也象	也像
乱斗	亂鬥
乱冲	亂衝
乱涂	亂塗
了准	了准
了准备	了準備
了准时	了準時
了准有	了準有
了准的	了準的
了准确	了準確
了如	了如
了如指掌	瞭如指掌
了望	瞭望
了然	瞭然
了然于胸	了然於胸
了若	了若
了若指掌	瞭若指掌
了解	瞭解
事也	事也
事也干	事也幹
事可	事可
事可干	事可幹
事好	事好
事好干	事好幹
事干	事幹
事干扰	事干擾
事干涉	事干涉
事干净	事乾淨
事干系	事幹係
事干脆	事乾脆
事干预	事干預
事情	事情
事情可干	事情可幹
事情好干	事情好幹
事情干	事情幹
事迹	事蹟
事都	事都
事都干	事都幹
事关	事關
二个	二個
二只	二隻
二天	二天
二天后	二天後
二手	二手
二手烟	二手菸
二撇	二撇
二撇胡	二撇鬍
二海	二海
二海里	二海里
二里	二里
二面	二面
互斗	互鬥
五只	五隻
五周	五週
五天	五天
五岳	五嶽
五海	五海
五海里	五海里
五里	五里
五里余	五里餘
五谷	五穀
五脏	五臟
些丑	些醜
些干	些干
些干头	些幹頭
些象	些像
亚里	亞里
交托	交託
交游	交遊
亦舍	亦舍
亦舍下	亦捨下
亦云	亦云
京沈	京瀋
亮丑	亮醜
人丑	人醜
人像	人像
人像征	人象徵
人干	人幹
人欲	人欲
人欲横流	人慾橫流
人游	人遊
人物	人物
人物志	人物誌
人象	人像
人赞	人讚
人云	人云
人云亦云	人云亦云
人云游	人云遊
人云集	人雲集
什幺	什麼
什幺女人	什麼女人
什锦	什錦
什锦面	什錦麵
什么	什麼
介系	介系
介系词	介係詞
介胄	介冑
仍斗	仍鬥
仍象	仍像
他不	他不
他不干渴	他不乾渴
他丑	他醜
他干	他幹
他干一杯	他乾一杯
他干儿子	他乾兒子
他干女儿	他乾女兒
他干扰	他干擾
他干涉	他干涉
他干净	他乾淨
他干爹	他乾爹
他干脆	他乾脆
他干预	他干預
他白	他白
他白干	他白幹
他象	他像
他象征战	他像征戰
付托	付託
仙后	仙后
仙游	仙遊
仙范	仙範
代征	代徵
代理	代理
令媛	令嬡
仰冲	仰衝
仿佛	彷彿
仿制	仿製
仿徉	彷徉
仿徨	徬徨
仿效	倣傚
休克	休克
伙伴	夥伴
伙同	夥同
伙夫	伙伕
伙众	夥眾
伙计	夥計
估不	估不
估不准	估不準
伴伙	伴夥
伴游	伴遊
伶敏	靈敏
伸卷	伸捲
伺奉	侍奉
似松	似松
似松实紧	似鬆實緊
但云	但云
低荡	低盪
低迥	低迴
住扎	住紮
占人	占人
占候	占候
占卜	占卜
占卦	占卦
占士	佔士
占士邦	占士邦
占梦	占夢
占射	占射
占拜	占拜
占断	占斷
占星	占星
占有	佔有
占有欲	佔有慾
占亲	占親
占课	占課
占身	占身
占风	佔風
占风使帆	占風使帆
占验	占驗
占凤	占鳳
余丈	餘丈
余下	餘下
余事	餘事
余人	餘人
余位	餘位
余低	餘低
余僇	餘僇
余僧	餘僧
余光	餘光
余光中	余光中
余刃	餘刃
余利	餘利
余剩	餘剩
余力	餘力
余劲	餘勁
余勇	餘勇
余势	餘勢
余匪	餘匪
余匹	餘匹
余只	餘隻
余名	餘名
余味	餘味
余地	餘地
余天	餘天
余姚	餘姚
余威	餘威
余子	餘子
余子碌碌	餘子碌碌
余字	餘字
余存	餘存
余孬	餘孬
余孽	餘孽
余寸	餘寸
余尺	餘尺
余年	餘年
余座	餘座
余廕	餘廕
余弦	餘弦
余怒	餘怒
余恨	餘恨
余息	餘息
余悸	餘悸
余情	餘情
余庆	餘慶
余愤	餘憤
余数	餘數
余日	餘日
余暇	餘暇
余晖	餘暉
余月	餘月
余杭	餘杭
余枝	餘枝
余桶	餘桶
余次	餘次
余款	餘款
余岁	餘歲
余殃	餘殃
余毒	餘毒
余气	餘氣
余水	餘水
余波	餘波
余海	余海
余海里	餘海里
余温	餘溫
余漏	餘漏
余沥	餘瀝
余烈	餘烈
余热	餘熱
余烬	餘燼
余物	餘物
余生	餘生
余亩	餘畝
余众	餘眾
余祸	餘禍
余粮	餘糧
余线	餘線
余缺	餘缺
余羹	餘羹
余者	餘者
余脉	餘脈
余兴	餘興
余荫	餘蔭
余裕	餘裕
余里	餘裡
余责	餘責
余贼	餘賊
余路	餘路
余载	餘載
余辉	餘輝
余辜	餘辜
余部	餘部
余钱	餘錢
余闲	餘閒
余震	餘震
余音	餘音
余韵	餘韻
余额	餘額
余风	餘風
余饭	餘飯
余香	餘香
余骑	餘騎
余点	餘點
余党	餘黨
佛历	佛曆
佛象	佛像
作准	作準
作奸	作奸
作奸犯科	作姦犯科
作崇	作祟
作废	作廢
作废后	作廢後
作的	作的
作的准	作的準
你丑	你醜
你干	你幹
你干一杯	你乾一杯
你干儿子	你乾兒子
你干女儿	你乾女兒
你干扰	你干擾
你干涉	你干涉
你干爹	你乾爹
你干脆	你乾脆
你干那杯	你乾那杯
你干预	你干預
你白	你白
你白干	你白幹
你象	你像
佩环	珮環
佩饰	珮飾
佳肴	佳餚
佳里	佳里
使心	使心
使心作幸	使心作倖
来干	來幹
来干扰	來干擾
来干旱	來乾旱
来干杯	來乾杯
来干枯	來乾枯
来干涉	來干涉
来干净	來乾淨
来干爽	來乾爽
来干脆	來乾脆
来干裂	來乾裂
来干预	來干預
来范	來範
来象	來像
例范	例範
侏罗	侏儸
仑背	崙背
供制	供製
依准	依準
依托	依託
侵并	侵併
侵范	侵範
便吃	便吃
便吃干	便吃乾
便松	便鬆
便象	便像
俊丑	俊醜
保不	保不
保不准	保不準
保准	保準
信托	信託
信缄	信箋
信而	信而
信而有征	信而有徵
修浚	修濬
修胡	修胡
修胡刀	修鬍刀
俯冲	俯衝
俱象	俱像
个象	個像
倍余	倍餘
倏松	倏鬆
们干	們幹
们干儿子	們干兒子
们干女儿	們干女兒
们干扰	們干擾
们干涉	們干涉
们干净	們干淨
们干爹	們干爹
们干脆	們干脆
们干预	們干預
倒仆	倒仆
倒卷	倒捲
倒象	倒像
倒霉	倒霉
倛丑	倛醜
借以	藉以
借口	藉口
借托	借託
借故	藉故
借机	藉機
借着	藉著
借词	藉詞
倦游	倦遊
值得	值得
值得一干	值得一幹
值得干	值得幹
假发	假髮
做了	做了
做出	做出
做出好戏	做齣好戲
做到	做到
做到象	做到像
停制	停製
停征	停徵
侧冲	側衝
偶象	偶像
偷梁	偷樑
傅里	傅裡
傅里叶	傅里葉
傍徨	徬徨
杰伦	杰倫
傒幸	傒倖
备注	備註
佣金	佣金
佣钱	佣錢
传布	傳佈
伤愈	傷癒
伤难	傷難
伤难愈	傷難癒
倾刻	頃刻
倾复	傾覆
偻罗	僂儸
仅余	僅餘
像征	象徵
像赞	像贊
像赞他	像讚他
像赞你	像讚你
像赞叹	像讚嘆
像赞她	像讚她
像赞我	像讚我
像赞扬	像讚揚
像赞美	像讚美
像赞许	像讚許
像赞誉	像讚譽
像赞赏	像讚賞
像赞颂	像讚頌
仆倒	仆倒
仆地	仆地
仆然	仆然
仆街	仆街
侥天	僥天
侥天之幸	僥天之悻
侥幸	僥倖
侥悻	僥倖
僵仆	僵仆
僵尸	殭屍
僵绳	韁繩
僵蚕	殭蠶
仪范	儀範
亿余	億餘
儆效	儆傚
俭朴	儉樸
儌幸	儌倖
儒子	儒子
儒子可教	孺子可教
优游	優遊
兀术	兀朮
元凶	元兇
元勋	元勛
充饥	充飢
充饥画饼	充饑畫餅
先奸	先姦
先干	先干
先干为敬	先乾為敬
光念	光唸
光致	光致
光致致	光緻緻
克克	剋剋
克剜	剋剜
克夫	剋夫
克扣	剋扣
克日	剋日
克星	剋星
克期	剋期
克死	剋死
克苦	刻苦
克薄	剋薄
克里	克里
克里斯多	克里斯多
克里斯托	克里斯托
免征	免徵
兜卷	兜捲
入伙	入夥
内函	內涵
内制	內製
内哄	內鬨
内斗	內鬥
内松	內松
内松外紧	內鬆外緊
内紧	內緊
内紧外松	內緊外鬆
内里	內裡
内脏	內臟
全台	全台
全日	全日
全日制	全日制
全里	全里
全象	全像
两个	兩個
两个中	兩個中
两制	兩制
两只	兩隻
两周	兩週
两天	兩天
两撇	兩撇
两撇胡	兩撇鬍
两海	兩海
两海里	兩海里
两里	兩里
两里余	兩里餘
八只	八隻
八周	八週
八天	八天
八天后	八天後
八字	八字
八字胡	八字鬍
八海	八海
八海里	八海里
八里	八里
八里余	八里餘
公余	公餘
公厘	公釐
公布	公佈
公干	公幹
公历	公曆
公里	公里
六只	六隻
六周	六週
六天	六天
六天后	六天後
六欲	六慾
六冲	六衝
六海	六海
六海里	六海里
六里	六里
六里余	六里餘
六须	六須
六须鲇	六鬚鯰
共制	共製
共御	共禦
共斗	共鬥
兵签	兵籤
其丑	其醜
其余	其餘
典范	典範
兼并	兼併
再丑	再醜
再制	再製
再卷	再捲
再干	再幹
再干一杯	再乾一杯
再斗	再鬥
再斗一斗	再鬥一鬥
再斗斗	再鬥鬥
再松	再鬆
再冲	再衝
再象	再像
冗余	冗餘
冬台	冬颱
冶游	冶遊
准不	准不
准不准备	準不準備
准不准确	準不準確
准不及	準不及
准不可	準不可
准不得	準不得
准不成	準不成
准不是	準不是
准不会	準不會
准不能	準不能
准且	准且
准且劲	準且勁
准些	準些
准以	准以
准以为	準以為
准倒	准倒
准倒霉	準倒霉
准备	準備
准儿	準兒
准准	準準
准到	準到
准则	準則
准博	准博
准博士	準博士
准叫	準叫
准叫你	準叫你
准可	準可
准司	准司
准司法	準司法
准吃	准吃
准吃亏	準吃虧
准噶	准噶
准噶尔	準噶爾
准外	准外
准外母	準外母
准外父	準外父
准够	準夠
准女	准女
准女婿	準女婿
准妈	准媽
准妈妈	準媽媽
准定	準定
准平	准平
准平原	準平原
准度	準度
准得	準得
准成	準成
准把	準把
准据	準據
准拟	準擬
准新	准新
准新娘	準新娘
准新郎	準新郎
准星	準星
准是	準是
准时	準時
准会	準會
准有	準有
准极	準極
准死	準死
准决	準決
准决斗	准決鬥
准决赛	準決賽
准没	準沒
准爸	准爸
准爸爸	準爸爸
准直	準直
准知	準知
准确	準確
准线	準線
准绳	準繩
准而	准而
准而快	準而快
准能	準能
准被	準被
准要	準要
准话	準話
准谱	准譜
准谱儿	準譜兒
准错	准錯
准错不了	準錯不了
准头	準頭
准点	準點
准！	準！
凛列	凜洌
凛栗	凜慄
凝干	凝乾
凯里	凱里
凶嫌	兇嫌
凶徒	兇徒
凶惧	兇懼
凶案	兇案
凶杀	兇殺
凶犯	兇犯
凶猛	兇猛
出丑	出醜
出了	出了
出了丑	出了醜
出个	出個
出个丑	出個醜
出槌	出鎚
出游	出遊
出的	出的
出的丑	出的醜
出籴	出糶
出过	出過
出过丑	出過醜
出电	出電
出电影	齣電影
函容	涵容
函复	函覆
函意	涵意
函数	函數
函洞	涵洞
函濡	涵濡
函煦	涵煦
函管	涵管
函义	涵義
函蓄	涵蓄
函盖	涵蓋
函蕴	涵蘊
函养	涵養
刀削	刀削
刀削面	刀削麵
分伙	分夥
分别	分別
分布	分佈
分象	分像
分道	分道
分道扬镖	分道揚鑣
分量	份量
分钟	分鐘
刑余	刑餘
初愈	初癒
初斗	初鬥
初斗然	初陡然
别干	別幹
别干扰	別干擾
别干杯	別乾杯
别干涉	別干涉
别干净	別乾淨
别干燥	別乾燥
别干爽	別乾爽
别干裂	別乾裂
别干预	別干預
别扭	彆扭
别扭来	別扭來
别拗	彆拗
别斗	別鬥
别气	彆氣
别脚	彆腳
别致	別緻
刨冰	鉋冰
刨刀	鉋刀
刨削	鉋削
刨子	鉋子
刨成	鉋成
刨花	鉋花
利欲	利慾
刮倒	颳倒
刮大	刮大
刮大风	颳大風
刮胡	刮鬍
刮胡刀	刮鬍刀
刮胡须	刮鬍鬚
刮起	颳起
刮须	刮鬚
刮风	颳風
制丹	製丹
制件	製件
制作	製作
制做	製做
制备	製備
制冰	製冰
制冷	製冷
制出	製出
制剂	製劑
制品	製品
制器	製器
制图	製圖
制成	製成
制播	製播
制材	製材
制毒	製毒
制法	製法
制为	製為
制炼	製煉
制片	製片
制版	製版
制程	製程
制糖	製糖
制纸	製紙
制药	製藥
制衣	製衣
制表	製表
制造	製造
制醋	製醋
制面	製麵
制面具	製面具
制革	製革
制鞋	製鞋
制馅	製餡
制盐	製鹽
刺不	刺不
刺不准	刺不準
刺准	刺準
刻象	刻像
刻象征服	刻像征服
剃发	剃髮
剃须	剃鬚
则象	則像
则象征战	則像征戰
则象征服	則像征服
则采	則採
锉刀	銼刀
锉工	銼工
锉平	銼平
削发	削髮
剌刀	刺刀
前仆	前僕
前仆后	前仆後
前冲	前衝
剩余	剩餘
剩肴	剩餚
剪彩	剪綵
剪发	剪髮
剪除	翦除
副丑	副丑
副丑相	副醜相
割舍	割捨
创制	創製
划不	劃不
划不来	劃不來
划来	划來
划去	划去
划单	劃單
划单人艇	划單人艇
划子	划子
划拳	划拳
划桨	划槳
划步	划步
划水	划水
划独	划獨
划算	划算
划舟	划舟
划船	划船
划艇	划艇
划双	劃雙
划双人	划雙人
划龙	划龍
剧斗	劇鬥
劈里	劈里
力干	力幹
力干扰	力干擾
力干政	力干政
力干涉	力干涉
力干预	力干預
力拼	力拚
力斗	力鬥
功勋	功勛
功亏	功虧
功亏一匮	功虧一簣
加上	加上
加卷	加捲
加涂	加塗
加里	加里
助理	助理
劫余	劫餘
劭雍	邵雍
劾系	劾繫
劲斗	勁鬥
勇斗	勇鬥
动荡	動盪
勘乱	戡亂
胜余	勝餘
劳力	勞力
劳力士表	勞力士錶
劳骚	牢騷
勤朴	勤樸
勋爵	勛爵
勋章	勛章
勋级	勛級
勾干	勾幹
包准	包準
包函	包涵
包卷	包捲
包扎	包紮
包谷	包穀
北回	北迴
北岳	北嶽
北极	北極
北极象	北極象
北冲	北衝
北游	北遊
北里	北里
匣钵	匣砵
匪干	匪幹
汇刊	彙刊
汇整	彙整
汇编	彙編
汇总	彙總
汇纂	彙纂
汇萃	薈萃
汇辑	彙輯
汇集	彙集
区别	區別
十余	十餘
十余只	十餘隻
十余里	十餘里
十分	十分
十分丑	十分醜
十分准	十分準
十分干	十分乾
十分的准	十分的準
十卷	十捲
十只	十隻
十周	十週
十天	十天
十海	十海
十海里	十海里
十里	十里
十里余	十里餘
十面	十面
千余	千餘
千余只	千餘隻
千余里	千餘里
千只	千隻
千层	千層
千层面	千層麵
千海	千海
千海里	千海里
千里	千里
千钧	千鈞
千钧一发	千鈞一髮
千锤	千錘
卅余	卅餘
升官	陞官
升平	昇平
升汞	昇汞
升泰	昇泰
升华	昇華
升迁	陞遷
升阳	昇陽
半只	半隻
半干	半乾
卒悉	窣窸
卒发	捽髮
卒草	捽草
卓约	卓約
卓约风姿	綽約風姿
南回	南迴
南岳	南嶽
南冲	南衝
南游	南遊
南里	南里
博斗	博鬥
卡里	卡里
卯上	卯上
卯上干	卯上幹
印制	印製
印象	印象
印象是	印象是
即像	即像
即像征服	即像征服
即像限制	即像限制
即象	即像
卷一	卷一
卷一卷	捲一捲
卷上	捲上
卷不	卷不
卷不起	捲不起
卷了	捲了
卷伏	捲伏
卷伴	捲伴
卷住	捲住
卷来	捲來
卷个	捲個
卷儿	捲兒
卷入	捲入
卷出	捲出
卷到	捲到
卷动	捲動
卷去	捲去
卷向	捲向
卷回	捲回
卷图	捲圖
卷土	捲土
卷土重来	捲土重來
卷好	捲好
卷射	捲射
卷尺	捲尺
卷往	捲往
卷得	捲得
卷心	捲心
卷心菜	捲心菜
卷成	捲成
卷拂	捲拂
卷扫	捲掃
卷拢	捲攏
卷旋	捲旋
卷曲	捲曲
卷款	捲款
卷毛	捲毛
卷浪	捲浪
卷涌	捲湧
卷滚	捲滾
卷烟	捲菸
卷发	捲髮
卷碎	捲碎
卷筒	捲筒
卷帘	捲簾
卷纸	捲紙
卷缩	捲縮
卷绕	捲繞
卷缠	捲纏
卷罩	捲罩
卷翘	捲翹
卷卧	捲臥
卷至	捲至
卷舌	捲舌
卷舞	捲舞
卷菸	捲菸
卷落	卷落
卷落叶	捲落葉
卷着	捲著
卷荡	捲蕩
卷衣	卷衣
卷衣袖	捲衣袖
卷袖	捲袖
卷裹	捲裹
卷袭	捲襲
卷走	捲走
卷起	捲起
卷身	捲身
卷轴	捲軸
卷逃	捲逃
卷进	捲進
卷过	捲過
卷铺	卷鋪
卷铺盖	捲鋪蓋
卷钢	捲鋼
卷开	捲開
卷须	捲鬚
卷风	捲風
卷飞	捲飛
却象	卻像
厄立	厄立
厄立特里	厄立特里
厘出	釐出
厘定	釐定
厘正	釐正
厘清	釐清
厘米	釐米
厘订	釐訂
去卷	去捲
去干	去幹
去干一杯	去乾一杯
去干了杯	去乾了杯
去干洗	去乾洗
去干净	去乾淨
去干耗	去乾耗
去乾着急	去乾著急
又丑	又醜
又咸	又鹹
又干	又幹
又干又	又乾又
又干又硬	又乾又硬
又干扰	又干擾
又干政	又干政
又干涉	又干涉
又干净	又乾淨
又干预	又干預
又斗	又鬥
又松	又鬆
又冲	又沖
又冲掉	又衝掉
又象	又像
又云	又云
反卷	反捲
反反	反反
反反复复	反反覆覆
反复	反覆
反朴	反朴
反朴归真	反璞歸真
反冲	反衝
取余	取餘
取准	取準
取舍	取捨
取谛	取締
受人	受人
受人之托	受人之託
受托	受託
受雇	受僱
口占	口占
口干	口乾
口干一	口幹一
口干什	口幹什
口干员	口幹員
口干掉	口幹掉
口干活	口幹活
口干着	口幹著
口干这	口幹這
口干那	口幹那
古朴	古樸
古法	古法
古法自制	古法自製
古迹	古蹟
古云	古云
另辟	另闢
只余	只餘
只兔	隻兔
只大	只大
只大老鼠	隻大老鼠
只字	隻字
只巨	只巨
只巨兽	隻巨獸
只影	隻影
只怪	只怪
只怪物	隻怪物
只怪兽	隻怪獸
只手	隻手
只招	只招
只招子	隻招子
只母	只母
只母老虎	隻母老虎
只涂	只塗
只牛	隻牛
只犬	隻犬
只狐	只狐
只狐狸	隻狐狸
只狗	隻狗
只狼	隻狼
只猛	只猛
只猛兽	隻猛獸
只猴	隻猴
只狮	隻獅
只畜	只畜
只畜生	隻畜生
只眼	隻眼
只羊	隻羊
只老	只老
只老狐狸	隻老狐狸
只老虎	隻老虎
只老鼠	隻老鼠
只声	只聲
只声不出	隻聲不出
只虎	隻虎
只蛋	隻蛋
只言	只言
只言片字	隻言片字
只言片语	隻言片語
只猪	隻豬
只猫	隻貓
只身	隻身
只身分	隻身份
只野	只野
只野兽	隻野獸
只鸡	隻雞
只马	隻馬
只骡	隻騾
只驴	隻驢
只鬼	隻鬼
只鸟	隻鳥
只凤	隻鳳
只鸭	隻鴨
只鹅	隻鵝
只鹰	隻鷹
只鹿	隻鹿
叫于	叫于
叮叮	叮叮
叮叮当当	叮叮噹噹
叮当	叮噹
可以	可以
可以干扰	可以干擾
可以干涉	可以干涉
可以干预	可以干預
可以象	可以像
可余	可餘
可干	可干
可干拭	可乾拭
可干擦	可乾擦
可干洗	可乾洗
可干湿	可乾濕
可干燥	可乾燥
可干衣	可乾衣
可干制	可乾製
可干饮	可乾飲
可紧	可緊
可紧可松	可緊可鬆
可象	可像
可象征战	可像征戰
可赞	可讚
可采	可採
台凳	檯凳
台制	台製
台子	檯子
台布	檯布
台布下	台佈下
台布告	台佈告
台布满	台佈滿
台布置	台佈置
台布署	台佈署
台布道	台佈道
台布防	台佈防
台干	台幹
台历	檯曆
台湾	台灣
台湾制	台灣製
台湾制定	台灣制定
台湾制度	台灣制度
台湾制订	台灣制訂
台灯	檯燈
台球	檯球
台钟	檯鐘
台面	檯面
台风	颱風
史迹	史蹟
右冲	右衝
叼扰	叨擾
叼难	刁難
吃不	吃不
吃不准	吃不準
吃准	吃準
吃完	吃完
吃完面	吃完麵
吃干	吃乾
吃干了	吃乾了
吃茶	喫茶
吃着	吃著
吃过	吃過
吃过面	吃過麵
吃面	吃麵
各干	各干
各干各	各幹各
合并	合併
合并不	合並不
合并且	合並且
合并非	合並非
合伙	合夥
合府	闔府
合斗	合鬥
合眼	闔眼
合第	闔第
吉占	吉占
吉里	吉里
吊信	弔信
吊取	弔取
吊古	弔古
吊唁	弔唁
吊问	弔問
吊喉	弔喉
吊丧	弔喪
吊场	弔場
吊奠	弔奠
吊孝	弔孝
吊客	弔客
吊影	弔影
吊念	弔念
吊慰	弔慰
吊文	弔文
吊旗	弔旗
吊书	弔書
吊死	吊死
吊死问疾	弔死問疾
吊民	弔民
吊民伐罪	弔民伐罪
吊祭	弔祭
吊系	吊繫
吊考	弔考
吊膀	吊膀
吊膀子	弔膀子
吊词	弔詞
吊诡	弔詭
吊贺	弔賀
吊钱	弔錢
同仇	同仇
同仇敌慨	同仇敵愾
同伙	同夥
同游	同遊
名字	名字
名字是于	名字是于
名迹	名蹟
后卫	後衛
吐干	吐乾
向准	向準
向午	晌午
向外	向外
向外冲	向外衝
向导	嚮導
向导游	嚮導遊
向往	嚮往
向后	向後
向后冲	向後衝
向应	嚮應
君子	君子
君子好求	君子好逑
吞并	吞併
吞咽	吞嚥
吟游	吟遊
吧台	吧檯
吮干	吮乾
吵斗	吵鬥
吸干	吸乾
吸得	吸得
吸得干干	吸得乾乾
吸烟	吸菸
吹卷	吹捲
吹干	吹乾
吹发	吹髮
吹胡	吹鬍
吹须	吹鬚
吕后	呂后
呆致	呆致
呆致致	呆緻緻
告侥	告饒
告别	告別
周一	週一
周一岳	周一嶽
周三	週三
周二	週二
周五	週五
周休	週休
周六	週六
周刊	週刊
周四	週四
周报	週報
周年	週年
周息	週息
周数	週數
周日	週日
周会	週會
周期	週期
周末	週末
周岁	週歲
周历	週曆
周波	週波
周游	周遊
周润	周潤
周润发	周潤發
周济	賙濟
周而	周而
周而复始	週而復始
周薪	週薪
周记	週記
周遭	週遭
呷干	呷乾
呼卷	呼捲
咀咽	咀嚥
咎征	咎徵
咕老	咕老
咕老肉	咕咾肉
咨商	諮商
咨询	諮詢
咨诹	諮諏
咨谋	諮謀
咨议	諮議
咬姜	咬姜
咬姜呷醋	咬薑呷醋
咬字	咬字
咬字不准	咬字不準
咸味	鹹味
咸咸	鹹鹹
咸土	鹹土
咸度	鹹度
咸得	鹹得
咸水	鹹水
咸海	鹹海
咸淡	鹹淡
咸湖	鹹湖
咸汤	鹹湯
咸湿	鹹濕
咸的	鹹的
咸肉	鹹肉
咸菜	鹹菜
咸蛋	鹹蛋
咸猪	鹹豬
咸类	鹹類
咸鱼	鹹魚
咸鸭	鹹鴨
咸卤	鹹鹵
咽一	咽一
咽一口	嚥一口
咽下	嚥下
咽不	咽不
咽不下	嚥不下
咽不了	嚥不了
咽了	嚥了
咽住	嚥住
咽入	嚥入
咽口	咽口
咽口水	嚥口水
咽唾	嚥唾
咽嚼	嚥嚼
咽回	嚥回
咽得	咽得
咽得下	嚥得下
咽气	嚥氣
咽苦	咽苦
咽苦吞甘	嚥苦吞甘
咽着	嚥著
咽食	嚥食
哀吊	哀弔
品汇	品彙
品尝	品嚐
哆罗	哆羅
哆罗哆嗦	哆囉哆嗦
哈罗	哈囉
哈里	哈里
员干	員干
员干将	員幹將
哥里	哥里
哪里	哪裡
哪象	哪像
哲云	哲云
唁吊	唁弔
唇干	唇乾
唇燥	唇燥
唇燥舌干	唇燥舌乾
唱游	唱遊
唾面	唾面
唾面自干	唾面自乾
商周	商周
商历	商曆
商铺	商舖
启发	啟發
啷当	啷噹
喂动	喂動
喂动物	餵動物
喂它	餵牠
喂羊	餵羊
喂猪	餵豬
喂马	餵馬
喂鱼	餵魚
善斗	善鬥
喉干	喉乾
喉干舌燥	喉乾舌燥
喉头	喉頭
喉头发干	喉頭發乾
喑哑	瘖啞
喝一	喝一
喝一坛	喝一罈
喝三	喝三
喝三坛	喝三罈
喝两	喝兩
喝两坛	喝兩罈
喝干	喝乾
喝斗	喝斗
喝斗声	喝鬥聲
喝白	喝白
喝白干	喝白乾
喧染	渲染
单单	單單
单于	單于
嗟吁	嗟吁
叹服	歎服
叹为	歎為
叹吁	嘆吁
叹羡	歎羨
叹赏	歎賞
喽罗	嘍囉
哗众	嘩眾
哗众取宠	譁眾取寵
唠叼	嘮叨
嘴干	嘴乾
嘹亮	嘹喨
嘘唏	歔欷
噪动	譟動
噪诈	譟詐
噫吁	噫吁
喷涂	噴塗
噜噜	嚕嚕
噜噜苏苏	嚕嚕囌囌
噜苏	嚕囌
严复	嚴復
啰里	囉里
嘱托	囑託
四个	四個
四只	四隻
四天	四天
四海	四海
四海里	四海里
四舍	四捨
四里	四里
四里余	四里餘
回佣	回佣
回光	回光
回光反照	迴光反照
回光返照	迴光返照
回卷	回捲
回圈	迴圈
回报	回報
回廊	迴廊
回复	回覆
回文	回文
回文诗	迴文詩
回旋	迴旋
回历	回曆
回冲	回衝
回游	迴游
回然	迥然
回环	迴環
回纹	迴紋
回绕	迴繞
回翔	迴翔
回肠	迴腸
回肠荡气	迴腸蕩氣
回荡	迴蕩
回诵	迴誦
回避	迴避
回銮	迴鑾
回阳	回陽
回阳荡气	迴陽蕩氣
回响	迴響
回响当	迴響當
回风	迴風
因奸	因奸
因奸成孕	因姦成孕
困乏	睏乏
困倦	睏倦
困意	睏意
困兽	困獸
困兽之斗	困獸之鬥
困兽斗	困獸鬥
困兽犹斗	困獸猶鬥
囹围	囹圉
固定	固定
固定制	固定制
圈梁	圈樑
国制	國製
国制定	國制定
国制度	國制度
国制订	國制訂
国家	國家
国小	國小
国小只	國小只
国历	國曆
国历代	國歷代
国历任	國歷任
国历史	國歷史
国历届	國歷屆
国历年	國歷年
国历尽	國歷盡
国历经	國歷經
国历险	國歷險
园游	園游
园游会	園遊會
圆椎	圓錐
图象	圖像
团伙	團夥
团子	糰子
团粉	糰粉
土制	土製
地一	地一
地一卷	地一捲
地卷	地捲
地干	地干
地干吧	地幹吧
地干杯	地乾杯 
地干燥	地乾燥
地干裂	地乾裂
地志	地誌
地冲	地衝
均沾	均霑
坎顶	崁頂
坐着	坐著
坤范	坤範
坦护	袒護
垂发	垂髮
垂范	垂範
型状	形狀
型范	型範
埃里	埃裡
埃里温	埃里溫
埔里	埔里
基准	基準
基干	基幹
报废	報廢
报废后	報廢後
报道	報導
塑象	塑像
塔里	塔裡
塔里木	塔里木
墓志	墓誌
坠胎	墮胎
增辟	增闢
墨沈	墨沈
墨沈未干	墨瀋未乾
垦辟	墾闢
坛佳	壇佳
坛佳酿	罈佳釀
坛坛	壇壇
坛坛罐罐	罈罈罐罐
坛女	壇女
坛女儿红	罈女兒紅
坛好	壇好
坛好酒	罈好酒
坛子	罈子
坛烧	壇燒
坛烧刀子	罈燒刀子
坛白	壇白
坛白干	罈白干
坛美	壇美
坛美酒	罈美酒
坛老	壇老
坛老酒	罈老酒
坛酒	罈酒
坛醋	罈醋
坛陈	壇陳
坛陈年	罈陳年
坛騞	罈騞
坛高	壇高
坛高粱	罈高粱
壑然	豁然
压咸	壓鹹
压面	壓面
压面棍	壓麵棍
坏签	壞籤
壶范	壺範
寿面	壽麵
夏历	夏曆
外制	外製
外强	外強
外强中干	外強中乾
外御	外御
外御强敌	外禦強敵
外松	外松
外松内紧	外鬆內緊
外涂	外塗
多丑	多醜
多余	多餘
多出	多出
多出电影	多齣電影
多少	多少
多少只	多少隻
多干	多干
多干了	多乾了
多干干	多乾乾
多干扰	多干擾
多干杯	多乾杯
多干涉	多干涉
多干净	多乾淨
多干燥	多乾燥
多干爽	多乾爽
多干系	多干系
多干脆	多乾脆
多干预	多干預
多海	多海
多海里	多海里
多里	多里
多么	多麼
多么丑	多麼醜
夜光	夜光
夜光表	夜光錶
夜游	夜遊
够不	夠不
够不着	搆不著
够准	夠準
够怨	搆怨
够涂	夠塗
够赞	夠讚
够钟	夠鐘
够钟情	夠鍾情
够钟爱	夠鍾愛
梦回	夢迴
梦游	夢遊
梦系	夢繫
大丑	大醜
大伙	大夥
大伙人	大夥人
大伙儿	大夥兒
大利	大利
大利面	大利麵
大只	大隻
大小	大小
大小只	大小只
大干	大干
大干特干	大幹特幹
大斗	大鬥
大历	大曆
大历史	大歷史
大润	大潤
大润发	大潤發
大冲	大沖
大冲击	大衝擊
大赞	大讚
天佑	天祐
天干	天干
天干物燥	天乾物燥
天后	天后
天生	天生
天生干	天生幹
天翻	天翻
天翻地复	天翻地覆
天象	天象
太不	太不
太不准	太不準
太丑	太醜
太准	太準
太初	太初
太初历	太初曆
太咸	太鹹
太太	太太
太干	太乾
太后	太后
太后面	太後面
太松	太鬆
太监	太監
太象	太像
夫奸	夫姦
夫役	伕役
失准	失準
夹衣	裌衣
夹袄	裌襖
奇丑	奇醜
奇准	奇準
奇迹	奇蹟
奏折	奏摺
奕棋	弈棋
奥斯	奧斯
奥斯卡	奧斯卡
夺斗	奪鬥
夺杯	奪盃
奋斗	奮鬥
奸凶	姦凶
奸夫	姦夫
奸妇	姦婦
奸尸	姦屍
奸情	姦情
奸拐	姦拐
奸杀	姦殺
奸污	姦污
奸淫	姦淫
奸盗	姦盜
奸通	姦通
她丑	她醜
她干	她幹
她干儿子	她乾兒子
她干女儿	她乾女兒
她干扰	她干擾
她干涉	她干涉
她干净	她乾淨
她干爹	她乾爹
她干脆	她乾脆
她干预	她干預
她象	她像
好丑	好醜
好像	好像
好像征式	好象徵式
好像征性	好象徵性
好准	好準
好咸	好鹹
好困	好困
好困吧	好睏吧
好困啊	好睏啊
好好	好好
好好地干	好好地幹
好好干	好好幹
好干	好幹
好斗	好鬥
好烟	好菸
好签	好籤
好象	好像
如何	如何
如何干	如何幹
如坐	如坐
如坐针毯	如坐針氈
如果	如果
如果象	如果像
姑负	辜負
姓名	姓名
姓名是于	姓名是于
姓于	姓于
姓钟	姓鍾
委托	委託
姜就	姜就
姜就是老	薑就是老
姜愈	姜愈
姜愈老	薑愈老
姜是	薑是
姜是老	薑是老
姜末	薑末
姜汁	薑汁
姜油	薑油
姜汤	薑湯
姜片	薑片
姜糖	薑糖
姜丝	薑絲
姜老	姜老
姜老辣	薑老辣
姜花	薑花
姜茶	薑茶
姜葱	薑蔥
姜还	姜還
姜还是老	薑還是老
姜醋	薑醋
姜饼	薑餅
姜黄	薑黃
姣洁	皎潔
娉亭	娉婷
婀挪	婀娜
嫌凶	嫌兇
嬉游	嬉遊
娇揉	嬌揉
娇揉造作	矯揉造作
嬖幸	嬖倖
嬴余	嬴餘
子姜	子薑
子钟	子鐘
子云	子云
字汇	字彙
存折	存摺
孱杂	羼雜
它象	它像
宅弟	宅第
宅紫	奼紫
守御	守禦
安全	安全
宏基	宏碁
定准	定準
定制	定製
定干	定幹
定干吧	定幹吧
客游	客遊
宣传	宣傳
宣传周	宣傳週
宣布	宣佈
室内	室內
宦游	宦遊
宴游	宴遊
家丑	家醜
家伙	傢伙
家俱	傢俱
家私	傢俬
家里	家裡
宸游	宸遊
容范	容範
寂聊	寂寥
寄托	寄託
密布	密佈
密折	密摺
密致	密緻
富余	富餘
寒仓	寒傖
寒喧	寒暄
寒栗	寒慄
寒而	寒而
寒而栗	寒而慄
寡欲	寡慾
实干	實幹
实象	實像
宁舍	寧捨
写字	寫字
写字台	寫字檯
宽松	寬鬆
宽范	寬範
寸余	寸餘
封后	封后
射不	射不
射不准	射不準
射准	射準
射雕	射鵰
专干	專幹
尊范	尊範
寻准	尋準
寻麻	蕁麻
对准	對準
对干	對幹
对华	對華
对着	對著
对象	對象
对象征	對象徵
导游	導遊
小丑	小丑
小丑丫鬟	小醜丫鬟
小伙	小夥
少干	少幹
少干扰	少干擾
少干涉	少干涉
少干系	少干係
少干预	少干預
少冲	少衝
少海	少海
少海里	少海里
少里	少里
尚余	尚餘
尤如	猶如
尤带	猶帶
尤怜	猶憐
尤疑	猶疑
尤里	尤里
尤豫	猶豫
就像	就像
就像征	就象徵
就吃	就吃
就吃干	就吃乾
就干	就干
就干一	就幹一
就干一杯	就乾一杯
就干吧	就幹吧
就干扰	就干擾
就干杯	就乾杯
就干涉	就干涉
就干净	就乾淨
就干爽	就乾爽
就干脆	就乾脆
就干预	就干預
就范	就範
就象	就像
尺余	尺餘
局促	侷促
局蹙	跼蹙
局躅	跼躅
局限	侷限
居里	居里
屋内	屋內
屋梁	屋樑
尸位	尸位
尸禄	尸祿
展布	展佈
屡仆	屢仆
层理	層理
属制	屬製
屯扎	屯紮
山岳	山嶽
山涯	山崖
山羊	山羊
山羊胡	山羊鬍
山羊须	山羊鬚
岳峙	嶽峙
岳立	嶽立
峇里	峇里
峇厘	峇里
峰回	峰迴
岛炼	島鍊
嵇首	稽首
巡回	巡迴
巡戈	巡弋
巡游	巡遊
工余	工餘
左冲	左衝
巧干	巧幹
巨制	巨製
巨子	鉅子
巨细	鉅細
巨细靡遗	鉅細靡遺
巨须	巨鬚
巨鹿	鉅鹿
己干	己幹
已余	已餘
已愈	已癒
已松	已鬆
已松下	已鬆下
已经	已經
已经斗	已經鬥
已经象	已經像
已象	已像
已象征战	已像征戰
已象征服	已像征服
巴尔	巴爾
巴尔干	巴爾幹
巴西	巴西
巴厘	峇里
布一	布一
布一个	佈一個
布伏	佈伏
布个	佈個
布兵	佈兵
布告	佈告
布坛	佈壇
布导	佈導
布局	佈局
布岗	佈崗
布于	佈於
布施	佈施
布景	佈景
布满	佈滿
布疑	布疑
布疑阵	佈疑陣
布置	佈置
布署	佈署
布着	佈著
布里	布里
布里斯托	布里斯托
布谷	布穀
布防	佈防
布阵	佈陣
布雷	佈雷
希拉	希拉
希拉里	希拉里
帕特	帕特
帕特里	帕特里
帝后	帝后
师云	師云
师云而云	師云而云
师范	師範
席卷	席捲
席子	蓆子
带征	帶徵
带发	帶髮
带着	帶著
常干	常幹
帽璎	帽纓
幡间	墦間
干一	幹一
干一坛	乾一罈
干一坛法	幹一壇法
干一杯	乾一杯
干一碗	乾一碗
干上	幹上
干下	干下
干下去	幹下去
干不	幹不
干不下	幹不下
干不干	幹不幹
干不干杯	乾不乾杯
干不干净	乾不乾淨
干了	幹了
干事	幹事
干井	乾井
干些	幹些
干什	幹什
干他	幹他
干件	幹件
干任	干任
干任何	幹任何
干份	幹份
干伸	干伸
干伸舌	乾伸舌
干似	乾似
干何	干何
干何事	幹何事
干你	幹你
干你娘	幹你娘
干个	幹個
干假	幹假
干傻	干傻
干傻事	幹傻事
干儿	乾兒
干两	干兩
干两年	幹兩年
干两杯	乾兩杯
干冒	干冒
干冒烟	乾冒煙
干冰	乾冰
干冷	乾冷
干出	幹出
干别	干別
干别的	幹別的
干到	幹到
干劲	幹勁
干化	乾化
干又	干又
干又热	乾又熱
干吏	幹吏
干咳	乾咳
干咽	乾嚥
干品	乾品
干员	幹員
干哥	乾哥
干哪	幹哪
干哭	乾哭
干哑	乾啞
干啥	幹啥
干吗	幹嗎
干呕	乾嘔
干嘛	幹嘛
干嚎	乾嚎
干土	乾土
干坐	干坐
干坐着	乾坐著
乾坤	乾坤
干坛	乾罈
干坛主	幹壇主
干坛法	幹壇法
干坏	干壞
干坏事	幹壞事
干大	干大
干大事	幹大事
干女	干女
干女儿	乾女兒
干女友	幹女友
干女同事	幹女同事
干女婿	乾女婿
干女教师	幹女教師
干她	幹她
干好	幹好
干妹	乾妹
干姊	乾姊
干姐	乾姐
干姜	乾薑
干娘	乾娘
干妈	乾媽
干季	乾季
干孙	乾孫
干完	幹完
干就	干就
干就干	幹就幹
干尸	乾屍
干巴	乾巴
干巴巴	乾巴巴
干布	乾布
干干	乾乾
干干巴巴	乾乾巴巴
干干净净	乾乾淨淨
干干爽爽	乾乾爽爽
干干瘦瘦	乾乾瘦瘦
干干的	乾乾的
干干脆脆	乾乾脆脆
干几	干幾
干几件	幹幾件
干几宗	幹幾宗
干几手	乾幾手
干几杯	乾幾杯
干几桩	幹幾樁
干几番	幹幾番
干几碗	乾幾碗
干几辈	幹幾輩
干底	乾底
干弋	干戈
干式	乾式
干弟	乾弟
干强	干強
干强盗	幹強盜
干得	幹得
干得一杯	乾得一杯
干得三杯	乾得三杯
干得两杯	乾得兩杯
干得很	乾得很
干性	乾性
干惯	幹慣
干成	幹成
干我	幹我
干手	干手
干手净脚	乾手淨腳
干才	幹才
干打	干打
干打雷	乾打雷
干掉	幹掉
干掉一杯	乾掉一杯
干掉一瓶	乾掉一瓶
干掉一碗	乾掉一碗
干掉杯	乾掉杯
干掉这杯	乾掉這杯
干掉这碗	乾掉這碗
干掉那杯	乾掉那杯
干掉那碗	乾掉那碗
干探	幹探
干撇	干撇
干撇下	乾撇下
干搁	乾擱
干数	干數
干数杯	乾數杯
干料	乾料
干旱	乾旱
干晒	乾曬
干材	幹材
干杯	乾杯
干果	乾果
干枝	乾枝
干枯	乾枯
干架	幹架
干柴	乾柴
干校	幹校
干梅	乾梅
干桩	幹樁
干正	干正
干正事	幹正事
干此	幹此
干此坛	乾此罈
干此杯	乾此杯
干毛	干毛
干毛巾	乾毛巾
干江	灨江
干沙	乾沙
干泥	乾泥
干洗	乾洗
干活	幹活
干流	幹流
干涸	乾涸
干净	乾淨
干清	干清
干清宫	乾清宮
干渴	乾渴
干涩	乾澀
干涧	乾澗
干湿	乾濕
干湿发	乾濕髮
干焦	乾焦
干熬	乾熬
干热	乾熱
干烧	乾燒
干燥	乾燥
干爸	乾爸
干爹	乾爹
干爽	乾爽
干犯	干犯
干犯法	幹犯法
干球	幹球
干甚	幹甚
干生	干生
干生气	乾生氣
干疤	乾疤
干瘦	乾瘦
干瘪	乾癟
干瘾	乾癮
干发	乾髮
干的	干的
干的好	幹的好
干尽	幹盡
干尽一坛	乾盡一磹
干尽一壶	乾盡一壺
干尽一杯	乾盡一杯
干尽一碗	乾盡一碗
干眼	乾眼
干瞪	乾瞪
干硬	乾硬
干窘	乾窘
干站	干站
干站着	乾站著
干笑	乾笑
干等	乾等
干粉	乾粉
干粗	干粗
干粗活	幹粗活
干粮	乾糧
干系	干係
干细	干細
干细胞	幹細胞
干结	乾結
乾丝	乾絲
乾纲	干綱
乾纲不振	乾綱不振
干线	幹線
干练	幹練
干耗	乾耗
干声	乾聲
干肉	乾肉
干肉贩	幹肉販
干股	乾股
干脆	乾脆
干花	乾花
干草	乾草
干菜	乾菜
干叶	乾葉
干着	幹著
乾着急	乾著急
干薪	乾薪
干号	乾號
干衣	乾衣
干裂	乾裂
干警	幹警
干货	乾貨
干货物	幹貨物
干买	干買
干买卖	幹買賣
干起	幹起
干路	幹路
干办	幹辦
干农	干農
干农活	幹農活
干透	乾透
干这	幹這
干这一杯	乾這一杯
干这杯	乾這杯
干过	幹過
干过一杯	乾過一杯
干过杯	乾過杯
干过瘾	乾過癮
干道	幹道
干那	幹那
干那一杯	乾那一杯
干那杯	乾那杯
干部	幹部
干酪	乾酪
干醋	乾醋
干错	幹錯
干阳	乾陽
乾隆	乾隆
干电	干電
干电池	乾電池
干面	乾麵
干面前	乾面前
干饭	乾飯
干么	幹麼
干点	幹點
干！	幹！
平准	平準
平台	平台
年余	年餘
年准	年准
年准到	年準到
年历	年曆
年历史	年歷史
幸免	倖免
幸存	倖存
幸幸	倖幸
幽郁	幽鬱
几乎	幾乎
几乎象	幾乎像
几个	幾個
几出	幾齣
几只	幾隻
几周	幾週
几天	幾天
几天后	幾天後
几案	几案
几海	幾海
几海里	幾海里
几净	几淨
几里	幾里
庇里	庇裡
庇里牛斯	庇里牛斯
床席	床蓆
床第	床笫
底里	底里
店伙	店夥
店铺	店舖
座象	座像
康愈	康癒
厨余	廚餘
厮斗	廝鬥
厮斗然	廝陡然
废后	廢后
广布	廣佈
广征	廣徵
延长	延長
廿余	廿餘
弄干	弄乾
弄松	弄鬆
弄面	弄面
弄面吃	弄麵吃
引发	引發
弘历	弘曆
弛骋	馳騁
弦乐	絃樂
弦歌	絃歌
弦琴	絃琴
弦管	絃管
弦索	絃索
弦线	絃線
弱干	弱幹
强力	強力
强力干性	強力乾性
强力干湿	強力乾濕
强台	強颱
强奸	強姦
强干	強幹
强干扰	強干擾
强干杯	強乾杯
强干涉	強干涉
强干脆	強乾脆
强干预	強干預
强征	強徵
强御	強禦
强冲	強衝
强界	疆界
弹子	彈子
弹子台	彈子檯
弹涂	彈塗
弹珠	彈珠
弹珠台	彈珠檯
弥山	彌山
弥山遍野	瀰山遍野
弥弥	瀰瀰
弥散	瀰散
弥漫	瀰漫
弥蒙	瀰濛
形单	形單
形单影只	形單影隻
形影	形影
形影相吊	形影相弔
形象	形象
彩女	綵女
彩带	綵帶
彩排	綵排
彩杖	綵杖
彩棚	綵棚
彩楼	綵樓
彩灯	綵燈
彩牌	綵牌
彩球	綵球
彩笔	彩筆
彩笔生	綵筆生
彩绸	綵綢
彩线	綵線
彩缎	綵緞
彩缯	綵繒
彩衣	綵衣
彩裳	綵裳
彩头	綵頭
彩凤	綵鳳
彩鸾	綵鸞
影后	影后
影象	影像
彷佛	彷彿
彷徨	徬徨
彼彼	彼彼
彼彼皆是	比比皆是
往外	往外
往外斗	往外鬥
往外冲	往外衝
往后	往後
往后冲	往後衝
征了	徵了
征人	徵人
征信	徵信
征个	徵個
征候	徵候
征兆	徵兆
征入	徵入
征兵	徵兵
征募	徵募
征去	徵去
征友	徵友
征取	徵取
征召	徵召
征启	徵啟
征地	徵地
征婚	徵婚
征引	徵引
征得	徵得
征意	征意
征意见	徵意見
征收	徵收
征敛	徵斂
征文	徵文
征服	征服
征服兵	徵服兵
征求	徵求
征片	徵片
征状	徵狀
征用	徵用
征税	徵稅
征稿	徵稿
征管	徵管
征粮	徵糧
征纳	徵納
征缴	徵繳
征聘	徵聘
征诏	徵詔
征询	徵詢
征调	徵調
征象	徵象
征财	徵財
征费	徵費
征赋	徵賦
征购	徵購
征逐	徵逐
征选	徵選
征集	徵集
很丑	很醜
很准	很準
很咸	很鹹
很干	很乾
很松	很鬆
很象	很像
后冠	后冠
后制	後製
后土	后土
后奸	後姦
后妃	后妃
后梁	後樑
后稷	后稷
后羿	后羿
后象	後像
后象征服	後像征服
径取	逕取
径启	逕啟
径寄	逕寄
径庭	逕庭
径砸	逕砸
径答	逕答
径自	逕自
徒峭	陡峭
徒托	徒託
得准	得準
得准不准	得準不準
得象	得像
徜若	倘若
御侮	禦侮
御制	御製
御寇	禦寇
御寒	禦寒
御敌	禦敵
徨恐	惶恐
复亡	覆亡
复仞	復仞
复仞年如	複仞年如
复以	復以
复以百万	複以百萬
复信	覆信
复函	覆函
复分	復分
复分数	複分數
复分解	複分解
复列	複列
复利	複利
复制	複製
复印	複印
复句	複句
复合	復合
复合传动	複合傳動
复合包装	複合包裝
复合型	複合型
复合增长	複合增長
复合字	複合字
复合式	複合式
复合性	複合性
复合技	複合技
复合材料	複合材料
复合板	複合板
复合架	複合架
复合模	複合模
复合机	複合機
复合物	複合物
复合管	複合管
复合膜	複合膜
复合药	複合藥
复合装甲	複合裝甲
复合词	複合詞
复合金属	複合金屬
复合体	複合體
复名	復名
复命	覆命
复基	復基
复基因	複基因
复壁	複壁
复姓	複姓
复字	復字
复字键	複字鍵
复审	覆審
复写	複寫
复巢	覆巢
复式	複式
复复	覆覆
复败	覆敗
复数	複數
复文	覆文
复方	複方
复书	覆書
复本	複本
复查	複查
复核	覆核
复检	複檢
复次	複次
复比	複比
复水	復水
复水难收	覆水難收
复决	複決
复没	覆沒
复测	複測
复灭	覆滅
复叠	覆疊
复目	複目
复相	復相
复相关	複相關
复眼	複眼
复种	複種
复线	複線
复习	複習
复舟	覆舟
复色	複色
复叶	複葉
复盖	覆蓋
复苏	復甦
复诊	複診
复词	複詞
复试	複試
复变	複變
复赛	複賽
复车	復車
复车之戒	覆車之戒
复辙	覆轍
复述	複述
复选	複選
复钱	複錢
复阅	複閱
复杂	複雜
复电	覆電
复音	複音
复韵	複韻
微松	微鬆
微软	微軟
微须	微鬚
德里	德里
徽菌	黴菌
心底	心底
心底里	心底裡
心理	心理
心相	心相
心相系	心相繫
心系	心繫
心系统	心系統
心细	心細
心细似发	心細似髮
心细如发	心細如髮
心脏	心臟
必游	必遊
必须	必須
必须品	必需品
忍饥	忍饑
志哀	誌哀
志喜	誌喜
志庆	誌慶
志异	誌異
志发	志發
快且	快且
快且准	快且準
快卷	快捲
快又	快又
快又准	快又準
快吃	快吃
快吃干	快吃乾
快干	快干
快干不	快幹不
快干了	快乾了
快干事	快幹事
快干吧	快幹吧
快干嘛	快幹嘛
快干完	快幹完
快干杯	快乾杯
快干死	快幹死
快干活	快幹活
快干裂	快乾裂
快干	快幹
快干啊	快幹啊
快快	快快
快快干	快快幹
快松	快松
快松下	快鬆下
快冲	快衝
快狠	快狠
快狠准	快狠準
快而	快而
快而准	快而準
快舍	快舍
快舍下	快捨下
念一	念一
念一念	唸一唸
念一声	唸一聲
念下	念下
念下去	唸下去
念了	念了
念了一声	唸了一聲
念佛	唸佛
念作	唸作
念来	念來
念来念去	唸來唸去
念到	唸到
念咒	唸咒
念好	唸好
念完	唸完
念得	唸得
念念	唸唸
念成	唸成
念书	唸書
念法	唸法
念给	唸給
念经	唸經
念着	唸著
念诵	唸誦
念起	念起
念起来	唸起來
念过	唸過
念错	唸錯
念点	唸點
忽松	忽鬆
忽舍	忽舍
忽舍下	忽捨下
怎幺	怎麼
怎么	怎麼
怎么干	怎麼幹
怎么斗	怎麼鬥
怒气	怒氣
怒气冲冲	怒氣衝衝
怒发	怒發
怒发冲冠	怒髮衝冠
怒发冲天	怒髮衝天
怕丑	怕醜
怖栗	怖慄
急卷	急捲
急征	急徵
急冲	急衝
性征	性徵
性欲	性慾
恂栗	恂慄
恢复	恢復
耻夺	褫奪
恭逢	躬逢
息影	息影
息影后	息影後
恰象	恰像
悒郁	悒鬱
悚栗	悚慄
悠游	悠遊
悲戚	悲慼
悲泯	悲憫
悲郁	悲鬱
闷郁	悶鬱
悸栗	悸慄
情欲	情慾
惕栗	惕慄
恶心	噁心
恶斗	惡鬥
想干	想幹
想干净	想乾淨
想干笑	想乾笑
想干脆	想乾脆
想斗	想鬥
想着	想著
想象	想像
惴栗	惴慄
惶栗	惶慄
惺松	惺忪
愁郁	愁鬱
愈卷	愈捲
愈合	癒合
愈合乎	愈合乎
愈合他	愈合他
愈合作	愈合作
愈合她	愈合她
愈合式	愈合式
愈合得	愈合得
愈合心	愈合心
愈合情	愈合情
愈合意	愈合意
愈合我	愈合我
愈合拍	愈合拍
愈合拢	愈合攏
愈合于	愈合於
愈合理	愈合理
愈合用	愈合用
愈合身	愈合身
愈合适	愈合適
愈斗	愈斗
愈斗愈	愈鬥愈
愈疮	癒瘡
愈象	愈像
意函	意涵
意兴	意興
意兴阑姗	意興闌珊
愚暗	愚闇
爱屋	愛屋
爱屋及鸟	愛屋及烏
爱欲	愛慾
感觉	感覺
感觉象	感覺像
惨栗	慘慄
慢咽	慢嚥
慰借	慰藉
忧郁	憂鬱
憋脚	蹩腳
凭借	憑藉
凭准	憑準
凭吊	憑弔
憔瘁	憔悴
恳托	懇託
懈松	懈鬆
懈迨	懈怠
应征	應徵
应象	應像
懊郁	懊鬱
懔栗	懍慄
懰栗	懰慄
怀表	懷錶
悬梁	懸樑
悬臂	懸臂
悬臂梁	懸臂樑
惧栗	懼慄
懿范	懿範
戊戍	戊戌
戊卫	戌衛
成长	成長
我丑	我醜
我干	我幹
我干一杯	我乾一杯
我干儿子	我乾兒子
我干女儿	我乾女兒
我干扰	我干擾
我干杯	我乾杯
我干涉	我干涉
我干爹	我乾爹
我干脆	我乾脆
我干预	我干預
我白	我白
我白干	我白幹
我象	我像
戒烟	戒菸
或咸	或鹹
或松	或鬆
或系	或系
或系之牛	或繫之牛
或采	或採
戚嗟	慼嗟
戚忧	慼憂
戚戚	慼慼
戚然	慼然
戚颜	慼顏
战天	戰天
战天斗地	戰天鬥地
战斗	戰鬥
战栗	顫慄
戏彩	戲綵
戏扎	戲紮
戴克	戴克
戴克里先	戴克里先
戴表	戴錶
所余	所餘
所制	所制
所制约	所制約
所制造	所製造
所卷	所捲
所布	所布
所布之	所佈之
所布的	所佈的
所干	所幹
所扎	所紮
所系	所繫
所见	所見
所见而云	所見而云
所谓	所謂
所谓而云	所謂而云
所讥	所譏
所讥而云	所譏而云
所采	改採
所钟	所鍾
所云	所云
扁锉	扁銼
扇动	搧動
扇耳	扇耳
扇耳光	搧耳光
扇开	搧開
扇风	搧風
手一	手一
手一卷	手一捲
手一松	手一鬆
手不	手不
手不松	手不鬆
手松	手鬆
手炼	手鍊
手表	手錶
手表态	手表態
手表演	手表演
手表现	手表現
手表示	手表示
手表达	手表達
手里	手裡
手里余	手裡餘
手采	手採
才不	才不
才不干杯	才不乾杯
才不干枯	才不乾枯
才不干涸	才不乾涸
才不干渴	才不乾渴
才不干燥	才不乾燥
才干	才幹
才干了杯	才乾了杯
才干干净	才乾乾淨
才干旱	才乾旱
才干杯	才乾杯
才干枯	才乾枯
才干涸	才乾涸
才干净	才乾淨
才干爽	才乾爽
才干耗	才乾耗
才干脆	才乾脆
才乾着急	才乾著急
才干透	才乾透
才干这杯	才乾這杯
才干那杯	才乾那杯
才松	才松
才松下	才鬆下
才象	才像
扎上	紮上
扎下	紮下
扎了	紮了
扎住	紮住
扎囮	紮囮
扎在	紮在
扎好	紮好
扎实	紮實
扎寨	紮寨
扎带	紮帶
扎彩	紮彩
扎成	紮成
扎扎	紮紮
扎根	紮根
扎营	紮營
扎稳	紮穩
扎结	紮結
扎紧	紮緊
扎脚	紮腳
扎着	紮著
扎裹	紮裹
扎诈	紮詐
扎起	紮起
扎辫	紮辮
打不	打不
打不准	打不準
打制	打製
打拼	打拚
打斗	打鬥
打谷	打穀
托了	託了
托事	託事
托交	託交
托人	託人
托付	託付
托古	託古
托名	託名
托咎	託咎
托梦	託夢
托大	託大
托孤	託孤
托故	託故
托疾	託疾
托病	託病
托管	託管
托言	託言
托词	託詞
托买	託買
托卖	託賣
托身	託身
托辞	託辭
托运	託運
托过	託過
扛丸	摃丸
扛龟	摃龜
扣准	扣準
扮象	扮像
扶余	扶餘
批复	批覆
批斗	批鬥
批注	批註
扼塞	阨塞
找不	找不
找不准	找不準
找准	找準
承制	承製
抉别	訣別
把你	把你
把你干	把我幹
把姜	把薑
把方	把方
把方才	把才纔
抑制	抑制
抑郁	抑鬱
抓不	抓不
抓不准	抓不準
抓准	抓準
抓奸	抓姦
抓斗	抓鬥
投不	投不
投不准	投不準
投准	投準
抗御	抗禦
抗斗	抗鬥
折》	摺》
折卷	折捲
折子	摺子
折扇	摺扇
折冲	折衝
折叠	摺疊
折痕	摺痕
折纸	摺紙
折裙	摺裙
披发	披髮
抬扛	抬摃
抱着	抱著
抵御	抵禦
抵牾	牴牾
抵犊	抵犢
抵犊情深	舐犢情深
抵砺	砥礪
抵触	牴觸
抹刹	抹煞
抹台	抹檯
抹干	抹乾
抺干	抺乾
抽佣	抽佣
抽干	抽乾
抽烟	抽菸
抽签	抽籤
抽象	抽象
抿灭	泯滅
拂须	拂鬚
拆伙	拆夥
拆封	拆封
拆封后	拆封後
拆斗	拆鬥
拈须	拈鬚
拉炼	拉鍊
拉纤	拉縴
拉着	拉著
拉里	拉里
拉面	拉麵
抛准	拋準
拌面	拌麵
拍出	拍出
拍出好戏	拍齣好戲
拍台	拍台
拍台拍凳	拍檯拍凳
拐子	枴子
拐杖	枴杖
拓本	搨本
拓朴	拓樸
拓朴学	拓樸學
拓碑	搨碑
拗别	拗彆
拘系	拘繫
拙壮	茁壯
拚命	拚命
拚命干	拚命幹
拚斗	拚鬥
招魂	招魂
招魂幡	招魂旛
拜占	拜佔
拜占庭	拜占庭
拜托	拜託
拭干	拭乾
拮据	拮据
拼一	拼一
拼一拼	拚一拚
拼上	拼上
拼上一拼	拚上一拚
拼个	拚個
拼力	拚力
拼劲	拚勁
拼命	拚命
拼得	拼得
拼得过	拚得過
拼搏	拚搏
拼政	拚政
拼斗	拚鬥
拼死	拚死
拼杀	拚殺
拼活	拚活
拼生	拚生
拼经	拚經
拼舍	拚捨
拿不	拿不
拿不准	拿不準
拿准	拿準
拿奸	拿姦
拿破	拿破
拿破仑	拿破崙
挑了	挑了
挑了只	挑了隻
挑大	挑大
挑大梁	挑大樑
挑斗	挑鬥
挖松	挖鬆
振荡	振盪
挹郁	挹鬱
挺准	挺準
挺而	鋌而
挺象	挺像
挽歌	輓歌
挽发	挽髮
挽联	輓聯
挽词	輓詞
挽诗	輓詩
挽近	輓近
捂不	捂不
捂不住	摀不住
捂住	摀住
捂盖	摀蓋
捆扎	捆紮
捉不	捉不
捉不准	捉不準
捉准	捉準
捉只	捉隻
捉奸	捉姦
捉狭	促狹
捋胡	捋鬍
捋虎	捋虎
捋虎须	捋虎鬚
捋须	捋鬚
捍御	捍禦
捍拒	扞拒
捍格	扞格
捏不	捏不
捏不准	捏不準
捏准	捏準
捏制	捏製
捭合	捭闔
捶台	捶台
捶台拍凳	捶檯拍凳
捻手	撚手
捻指	撚指
捻胡	捻鬍
捻花	撚花
捻钱	撚錢
捻须	撚鬚
捻香	撚香
掀卷	掀捲
扫卷	掃捲
扫描	掃瞄
掉发	掉髮
掉发出	掉發出
掉发现	掉發現
掉发现象	掉髮現象
掌握	掌握
排泄	排泄
排骨	排骨
排骨面	排骨麵
掘松	掘鬆
挣松	掙鬆
挂彩	掛綵
挂历	掛曆
挂碍	罣礙
掠冲	掠衝
探知	探知
探知欲	探知慾
接斗	接鬥
控制	控制
控制欲	控制慾
控制面板	控制面板
推刨	推鉋
推情	推情
推情准理	推情準理
揉制	揉製
揉躏	蹂躪
揉面	揉麵
描涂	描塗
换只	換隻
换签	換籤
握不	握不
握不准	握不準
握准	握準
握发	握髮
握着	握著
揩台	揩檯
揩干	揩乾
揪采	揪採
揭丑	揭醜
挥别	揮別
挥卷	揮捲
挥杆	揮杆
挥发	揮發
挥发油	揮發油
搏斗	搏鬥
搜罗	蒐羅
搜证	蒐證
搜购	蒐購
搜集	蒐集
摒息	屏息
摸不	摸不
摸不准	摸不準
摸准	摸準
摺云	摺云
撞球	撞球
撞球台	撞球檯
掸子	撢子
抚恤	撫卹
抚须	撫鬚
撬松	撬鬆
扑卷	撲捲
挞虏	韃虜
挡御	擋禦
擐系	擐繫
担仔	擔仔
担仔面	擔仔麵
担担	擔擔
担担面	擔擔麵
擢发	擢髮
擢足	濯足
擦干	擦乾
擦干	擦乾
拧干	擰乾
拧松	擰鬆
摆布	擺佈
摆荡	擺盪
拢断	壟斷
摄制	攝製
摄影	攝影
摄影后	攝影後
摄服	懾服
摄象	攝像
挛生	孿生
支干	支幹
支烟	支菸
支签	支籤
收获	收穫
收采	收採
改念	改唸
改采	改採
放姜	放薑
放松	放鬆
放着	放著
故布	故佈
故里	故里
效尤	傚尤
效法	傚法
敖游	敖遊
教悔	教誨
教范	教範
敢再	敢再
敢再干杯	敢再乾杯
敢干	敢幹
敢念	敢唸
敢拼	敢拚
敢斗	敢鬥
敢松	敢鬆
散伙	散夥
散布	散佈
散署	佈署
敦厚	惇厚
敦敦	惇惇
敦朴	惇樸
敦睦	惇睦
敦笃	惇篤
敦诲	惇誨
敦谨	惇謹
整并	整併
整个	整個
整出	整出
整出剧	整齣劇
整出戏	整齣戲
整只	整隻
整周	整週
敷涂	敷塗
数只	數隻
数周	數週
数天	數天
数海	數海
数海里	數海里
数里	數里
文丑	文醜
文汇	文匯
文汇报	文匯報
文斗	文鬥
斑烂	斑斕
斗一	鬥一
斗一斗	鬥一鬥
斗上	鬥上
斗上一斗	鬥上一鬥
斗下	斗下
斗下去	鬥下去
斗不	鬥不
斗不过	鬥不過
斗久	鬥久
斗了	鬥了
斗了一斗	鬥了一鬥
斗什	斗什
斗什么	鬥什麼
斗他	鬥他
斗他一斗	鬥他一鬥
斗你	鬥你
斗来	鬥來
斗个	鬥個
斗倒	鬥倒
斗传	鬥傳
斗内	斗內
斗内力	鬥內力
斗出	鬥出
斗到	鬥到
斗剑	鬥劍
斗力	鬥力
斗劲	鬥勁
斗勇	鬥勇
斗胜	鬥勝
斗十	斗十
斗十余	鬥十餘
斗去	鬥去
斗口	鬥口
斗命	鬥命
斗嘴	鬥嘴
斗在	鬥在
斗垮	鬥垮
斗场	鬥場
斗士	鬥士
斗奇	鬥奇
斗她	鬥她
斗她一斗	鬥她一鬥
斗妍	鬥妍
斗完	鬥完
斗定	斗定
斗定力	鬥定力
斗将	鬥將
斗就	斗就
斗就斗	鬥就鬥
斗弄	鬥弄
斗得	鬥得
斗心	鬥心
斗忍	鬥忍
斗志	鬥志
斗快	鬥快
斗恶	鬥惡
斗意	鬥意
斗成	鬥成
斗我	鬥我
斗战	鬥戰
斗批	鬥批
斗技	鬥技
斗招	鬥招
斗拱	斗栱
斗拳	鬥拳
斗掌	鬥掌
斗擞	抖擻
斗败	鬥敗
斗敌	鬥敵
斗斗	鬥鬥
斗智	鬥智
斗本	斗本
斗本事	鬥本事
斗棋	鬥棋
斗机	斗機
斗机智	鬥機智
斗杀	鬥殺
斗殴	鬥毆
斗气	鬥氣
斗法	鬥法
斗灼	斗杓
斗然	陡然
斗争	鬥爭
斗牛	鬥牛
斗狗	鬥狗
斗狠	鬥狠
斗兽	鬥獸
斗毕	鬥畢
斗百	斗百
斗百余	鬥百餘
斗的	斗的
斗的过	鬥的過
斗眼	鬥眼
斗神	鬥神
斗私	鬥私
斗舰	鬥艦
斗草	鬥草
斗着	鬥著
斗艺	鬥藝
斗蟋	斗蟋
斗蟋蟀	鬥蟋蟀
斗角	鬥角
斗艳	鬥豔
斗赢	鬥贏
斗起	鬥起
斗趣	鬥趣
斗输	鬥輸
斗过	鬥過
斗酒	鬥酒
斗鸡	鬥雞
斗饮	鬥飲
斗闹	鬥鬧
斗魂	鬥魂
斗鱼	鬥魚
斗鹌	斗鵪
斗鹌鹑	鬥鵪鶉
斗丽	鬥麗
斗！	鬥！
料不	料不
料不准	料不準
料准	料準
斛斗	觔斗
斜冲	斜衝
斯里	斯里
新征	新徵
新历	新曆
新历史	新歷史
新舄	新潟
断发	斷髮
方便	方便
方便面	方便麵
于先	於先
于先生	于先生
于右	於右
于右任	于右任
于嗟	于嗟
于小	於小
于小姐	于小姐
于思	於思
于思于思	于思于思
于成	於成
于成龙	于成龍
于于	于于
于归	于歸
于归来	於歸來
于归去	於歸去
于归回	於歸回
于归家	於歸家
于归程	於歸程
于归路	於歸路
于归途	於歸途
于归还	於歸還
于氏	于氏
于美	於美
于美人	于美人
于谦	于謙
于阗	于闐
于飞	於飛
于飞之乐	于飛之樂
施舍	施捨
旁征	旁征
旁征博引	旁徵博引
旁徨	徬徨
旁惶	徬徨
旁注	旁註
旅游	旅遊
旋卷	旋捲
旋松	旋鬆
旋涡	漩渦
旗幡	旗旛
旗杆	旗杆
既准	既准
既准且	既準且
既象	既像
日余	日餘
日制	日製
日制定	日制定
日制订	日制訂
日升	日昇
日干	日干
日干夜干	日幹夜幹
日志	日誌
日本	日本
日本制	日本製
日本制定	日本制定
日本制订	日本制訂
日历	日曆
日历史	日歷史
日历年	日歷年
日历经	日歷經
日游	日遊
早占	早佔
早占勿药	早占勿藥
旬余	旬餘
旱烟	旱菸
昆仑	崑崙
昆山	崑山
昆曲	崑曲
昆腔	崑腔
明范	明範
昏瞑	昏暝
易斗	易斗
易斗的	易鬥的
易松	易鬆
星历	星曆
星历代	星歷代
星历任	星歷任
星历史	星歷史
星历尽	星歷盡
星历经	星歷經
星历险	星歷險
星辰	星辰
星辰表	星辰錶
映象	映像
春卷	春捲
春游	春遊
是丑	是醜
是干	是干
是干的	是乾的
是干脆	是乾脆
是白	是白
是白干	是白幹
时干	時干
时干下	時幹下
时宪	時憲
时宪历	時憲曆
晋升	晉陞
普里	普里
景致	景緻
智斗	智鬥
晾干	晾乾
暗伦	闇倫
暗冥	闇冥
暗劣	闇劣
暗弱	闇弱
暗斗	暗鬥
暗然	闇然
暗藏	暗藏
暗藏着	暗藏著
暗赞	暗讚
暝目	瞑目
畅游	暢遊
暂松	暫鬆
暴卷	暴捲
暴冲	暴衝
暴珍	暴珍
暴珍天物	暴殄天物
晒干	曬乾
晒谷	曬穀
曲卷	曲捲
曲薛	麴薛
曲酒	麴酒
更丑	更醜
更准	更準
更加	更加
更加丑	更加醜
更咸	更鹹
更松	更鬆
更要	更要
更要丑	更要醜
更象	更像
书台	書檯
书童	書僮
书签	書籤
最丑	最醜
最准	最準
会干	會幹
会干扰	會干擾
会干杯	會乾杯
会干涸	會乾涸
会干净	會乾淨
会干脆	會乾脆
会干裂	會乾裂
会斗	會鬥
会象	會像
会象棋	會象棋
月余	月餘
月历	月曆
有余	有餘
有出	有出
有出好戏	有齣好戲
有得	有得
有得斗	有得鬥
有感	有感
有感而云	有感而云
有象	有像
有象征	有象徵
有关	有關
有关系	有關係
有点	有點
有点丑	有點醜
服贗	服膺
朝干	朝乾
木制	木製
木梁	木樑
木签	木籤
木纳	木訥
未干	未乾
未愈	未癒
未斗	未鬥
未松	未松
未松下	未鬆下
未松口	未鬆口
未端	末端
本周	本週
朱喻	硃喻
朱批	硃批
朱砂	硃砂
朱矶	硃磯
朱笔	硃筆
朴修	朴修
朴修斯	樸修斯
朴学	樸學
朴实	樸實
朴拙	樸拙
朴玉	璞玉
朴直	樸直
朴素	樸素
朴质	樸質
朴野	樸野
李钟	李鐘
李钟郁	李鍾郁
材干	材幹
村落	村落
束发	束髮
杯干	杯乾
杯白	杯白
杯白干	杯白乾
杯面	杯麵
东升	東昇
东周	東周
东岳	東嶽
东东	東東
东东里面	東東裡面
东冲	東衝
东涂	東塗
东游	東遊
东涌	東涌
东里	東里
松一	松一
松一下	鬆一下
松一些	鬆一些
松一口气	鬆一口氣
松一松	鬆一鬆
松下	松下
松下一口	鬆下一口
松下了	鬆下了
松下来	鬆下來
松不	松不
松不松	鬆不鬆
松不紧	鬆不緊
松不开	鬆不開
松了	鬆了
松了松	鬆了鬆
松些	鬆些
松出	松出
松出一	鬆出一
松出口	鬆出口
松劲	鬆勁
松动	鬆動
松化	鬆化
松去	鬆去
松口	鬆口
松土	鬆土
松垮	鬆垮
松塌	鬆塌
松宽	鬆寬
松干	松幹
松弛	鬆弛
松得	松得
松得多	鬆得多
松快	鬆快
松懈	鬆懈
松手	鬆手
松掉	鬆掉
松放	鬆放
松散	鬆散
松晃	鬆晃
松松	鬆鬆
松柔	鬆柔
松毛	松毛
松毛松翼	鬆毛鬆翼
松气	鬆氣
松油	松油
松油管	鬆油管
松油门	鬆油門
松泛	鬆泛
松泥	鬆泥
松浮	鬆浮
松球	松毬
松甩	鬆甩
松筋	鬆筋
松糕	鬆糕
松绑	鬆綁
松紧	鬆緊
松线	鬆線
松缓	鬆緩
松绳	鬆繩
松肘	鬆肘
松肩	鬆肩
松脆	鬆脆
松脱	鬆脫
松腰	鬆腰
松蛋	鬆蛋
松解	鬆解
松起	鬆起
松软	鬆軟
松通	鬆通
松开	鬆開
松闲	鬆閒
松饼	鬆餅
松驰	鬆弛
松骨	鬆骨
松齿	鬆齒
板锉	板銼
果干	果乾
果系	果係
果系统	果系統
枝干	枝幹
枝芽	枝枒
枯干	枯幹
架梁	架樑
某只	某隻
染发	染髮
柔发	柔髮
柱梁	柱樑
栓住	拴住
栗人	慄人
栗冽	慄冽
栗栗	慄慄
栗然	慄然
栗声	慄聲
栗惊	慄驚
校准	校準
株象	株像
核复	核覆
根烟	根菸
格斗	格鬥
格范	格範
格里	格里
格里历	格里曆
桅杆	桅杆
案几	案几
桌面	桌面
桑干	桑乾
杆面	桿麵
梁上	樑上
梁下	樑下
梁折	樑折
梁柱	樑柱
梁脊	樑脊
梗直	鯁直
梯冲	梯衝
械斗	械鬥
梳发	梳髮
弃舍	棄捨
棉制	棉製
棕发	棕髮
栋梁	棟樑
棵象	棵像
植发	植髮
业余	業餘
极丑	極醜
极准	極準
极干	極乾
极待	極待
极待救	亟待救
极待解	亟待解
极极	亟亟
极象	極像
榔头	鎯頭
榨取	搾取
榨干	榨乾
榨渣	搾渣
榨甘	榨甘
榨甘蔗	搾甘蔗
榴连	榴槤
构陷	搆陷
槌打	搥打
槌背	搥背
槌胸	搥胸
槌头	鎚頭
槌鼓	搥鼓
标准	標準
标志	標誌
标杆	標竿
标注	標註
标签	標籤
标致	標緻
枢钮	樞紐
模制	模製
模范	模範
样丑	樣醜
样干	樣幹
样范	樣範
樵采	樵採
树干	樹幹
桥梁	橋樑
橘梗	桔梗
机器	機器
机器压制	機器壓製
机抒	機杼
横卷	橫捲
横征	橫徵
横梁	橫樑
横冲	橫衝
柜台	櫃檯
栏杆	欄杆
权力	權力
权力欲	權力慾
权斗	權鬥
欠准	欠準
欲令	欲令
欲令智昏	慾令智昏
欲壑	慾壑
欲女	慾女
欲孽	慾孽
欲念	慾念
欲望	慾望
欲求	欲求
欲求不满	慾求不滿
欲海	慾海
欲火	慾火
欲舍	欲捨
欲障	慾障
欷吁	欷吁
欺蒙	欺矇
钦崎	嶔崎
歉咎	歉疚
欧游	歐遊
正正	正正
正正当当	正正當當
正象	正像
此丑	此醜
步步	步步
步步高升	步步高陞
武斗	武鬥
历数	曆數
历日	曆日
历书	曆書
历月	曆月
历法	曆法
历落	曆落
历象	曆象
归并	歸併
归并不	歸並不
归并且	歸並且
归并非	歸並非
归依	歸依
归依佛门	皈依佛門
归依我佛	皈依我佛
归朴	歸璞
归真	歸真
归真反朴	歸真反璞
归究	歸咎
归里	歸里
死斗	死鬥
殊勋	殊勛
残余	殘餘
残干	殘幹
残废	殘廢
残废后	殘廢後
残肴	殘餚
殷勤	慇勤
毁谤	譭謗
殴斗	毆鬥
母丑	母醜
母后	母后
母范	母範
每只	每隻
每周	每週
比拼	比拚
比斗	比鬥
毛制	毛製
毛姜	毛薑
毛发	毛髮
毛里	毛裡
毛里求斯	毛里求斯
毛里裘斯	毛里裘斯
毛须	毛鬚
毫厘	毫釐
毫发	毫髮
民制	民製
气一	氣一
气一冲	氣一衝
气慨	氣概
气象	氣象
气郁	氣鬱
氤郁	氤鬱
水一	水一
水一冲	水一衝
水再	水再
水再冲	水再衝
水准	水準
水又	水又
水又冲	水又衝
水已	水已
水已干	水已乾
水已冲	水已衝
水干	水乾
水干掉	水乾掉
水干尽	水乾盡
水急	水急
水急冲	水急衝
水才	水才
水才干	水才乾
水冲	水沖
水泄	水泄
水泄不通	水洩不通
水清	水清
水清可见	水清可鑑
水濂	水簾
水谷	水谷
水谷之海	水穀之海
水道	水道
永志	永誌
永历	永曆
求知	求知
求知欲	求知慾
求签	求籤
污蔑	污衊
汨没	汩沒
决心	決心
决心干	決心幹
决择	抉擇
决斗	決鬥
沈淀	沈澱
沈郁	沈鬱
沈阳	瀋陽
沉淀	沉澱
沉郁	沉鬱
没准	沒準
没干	沒幹
没干净	沒乾淨
没干头	沒幹頭
没念	沒唸
没松	沒松
没松下	沒鬆下
没松口	沒鬆口
没松手	沒鬆手
没白	沒白
没白干	沒白幹
没辄	沒轍
冲上	沖上
冲上来	衝上來
冲下	衝下
冲不	沖不
冲不上	衝不上
冲不下	衝不下
冲不入	衝不入
冲不出	衝不出
冲不破	衝不破
冲不进	衝不進
冲不过	衝不過
冲不开	衝不開
冲乱	衝亂
冲了	沖了
冲了上	衝了上
冲了下	衝了下
冲了来	衝了來
冲了入	衝了入
冲了出	衝了出
冲了进	衝了進
冲了过	衝了過
冲他	衝他
冲你	衝你
冲来	衝來
冲倒	衝倒
冲克	衝克
冲入	衝入
冲冠	衝冠
冲出	衝出
冲到	衝到
冲刺	衝刺
冲克	衝剋
冲剌	衝剌
冲前	衝前
冲剑	衝劍
冲力	衝力
冲劲	衝勁
冲动	衝動
冲势	衝勢
冲去	衝去
冲口	衝口
冲向	衝向
冲向前	衝向前
冲呀	衝呀
冲咱	衝咱
冲啊	衝啊
冲回	衝回
冲在	沖在
冲在下	衝在下
冲在前	衝在前
冲在最前	衝在最前
冲坚	衝堅
冲坠	衝墜
冲天	衝天
冲奔	衝奔
冲她	衝她
冲将	衝將
冲往	衝往
冲得	沖得
冲得入	衝得入
冲得出	衝得出
冲得进	衝得進
冲得过	衝得過
冲心	衝心
冲我	衝我
冲拳	衝拳
冲掠	衝掠
冲撞	衝撞
冲扑	衝撲
冲击	衝擊
冲断	衝斷
冲杀	衝殺
冲决	衝決
冲冲	沖沖
冲冲冲	衝衝衝
冲波	衝波
冲浪	衝浪
冲激	衝激
冲然	衝然
冲犯	衝犯
冲盹	沖盹
冲盹儿	衝盹兒
冲破	衝破
冲程	衝程
冲穴	衝穴
冲突	衝突
冲脉	衝脈
冲自	沖自
冲自己	衝自己
冲至	衝至
冲落	衝落
冲着	衝著
冲要	衝要
冲起	衝起
冲越	衝越
冲跑	衝跑
冲军	衝軍
冲近	衝近
冲进	衝進
冲过	衝過
冲量	衝量
冲锋	衝鋒
冲锋枪	衝鋒槍
冲错	衝錯
冲门	衝門
冲开	衝開
冲闯	衝闖
冲阵	衝陣
冲陷	衝陷
冲头	沖頭
冲头阵	衝頭陣
冲风	衝風
冲驰	衝馳
冲！	衝！
河落	河落
河落海干	河落海乾
油面	油麵
治愈	治癒
治疔	治療
沾污	玷汙
沾污	玷汙
沾辱	玷辱
沿着	沿著
泛游	泛遊
泛滥	氾濫
泡制	泡製
泡面	泡麵
波里	波里
泥涂	泥塗
泥象	泥像
注:	註:
注上	註上
注册	註冊
注失	註失
注明	註明
注标	註標
注生	注生
注生娘娘	註生娘娘
注疏	註疏
注脚	註腳
注解	註解
注记	註記
注译	註譯
注释	註釋
注销	註銷
注：	註：
泰历	泰曆
泱郁	泱鬱
洗手	洗手
洗手不干	洗手不幹
洗发	洗髮
洗发动机	洗發動機
泄欲	洩慾
泄殖	泄殖
泄沓	泄沓
泄泄	泄泄
洪范	洪範
洲杯	洲盃
洲游	洲遊
活干	活幹
活象	活像
流卷	流捲
流干	流乾
流风	流風
流风余	流風餘
浚深	濬深
浪一	浪一
浪一冲	浪一衝
浪卷	浪捲
浪又	浪又
浪又冲	浪又衝
浪冲	浪衝
浪琴	浪琴
浪琴表	浪琴錶
浮松	浮鬆
浮签	浮籤
海函	海涵
海干	海乾
浸制	浸製
涂上	塗上
涂了	塗了
涂来	涂來
涂来涂去	塗來塗去
涂到	塗到
涂制	塗製
涂去	塗去
涂在	塗在
涂地	塗地
涂好	塗好
涂写	塗寫
涂层	塗層
涂布	塗布
涂得	塗得
涂成	塗成
涂抹	塗抹
涂掉	塗掉
涂改	塗改
涂料	塗料
涂有	塗有
涂油	塗油
涂涂	塗塗
涂消	塗消
涂满	塗滿
涂漆	塗漆
涂潭	塗潭
涂炭	塗炭
涂窜	塗竄
涂粉	塗粉
涂脂	塗脂
涂胶	塗膠
涂色	塗色
涂着	塗著
涂药	塗藥
涂蜡	塗蠟
涂装	塗裝
涂覆	塗覆
涂说	塗說
涂过	塗過
涂销	塗銷
涂饰	塗飾
涂鸦	塗鴉
涂鸭	塗鴨
涂黑	塗黑
涅盘	涅槃
消费	消費
消费欲	消費慾
液晶	液晶
液晶表	液晶錶
凉席	涼蓆
凉面	涼麵
淀粉	澱粉
淑范	淑範
凄息	棲息
凄戚	悽慼
泪干	淚乾
泪难	淚難
泪难干	淚難乾
净余	淨餘
净几	淨几
淫欲	淫慾
淬厉	淬礪
淳于	淳于
淳朴	淳樸
混肴	混淆
清扫	清掃
清扫夫	清掃伕
清淅	清晰
清理	清理
清道	清道
清道夫	清道伕
减征	減徵
渠冲	渠衝
测不	測不
测不准	測不準
测准	測準
港制	港製
游中	游中
游中国	遊中國
游亚	游亞
游亚洲	遊亞洲
游人	遊人
游仙	遊仙
游伴	遊伴
游侠	遊俠
游兵	遊兵
游冶	遊冶
游刃	遊刃
游北	游北
游北美	遊北美
游台	游台
游台湾	遊台灣
游唱	遊唱
游园	遊園
游子	遊子
游学	遊學
游客	遊客
游宦	遊宦
游山	遊山
游巡	遊巡
游廊	遊廊
游必	游必
游必有方	遊必有方
游惰	遊惰
游憩	遊憩
游戏	遊戲
游斗	游鬥
游方	遊方
游星	遊星
游乐	遊樂
游欧	游歐
游欧洲	遊歐洲
游历	遊歷
游湖	遊湖
游澳	游澳
游澳洲	遊澳洲
游牧	遊牧
游狎	遊狎
游猎	遊獵
游玩	遊玩
游目	遊目
游美	游美
游美洲	遊美洲
游兴	遊興
游船	遊船
游艇	遊艇
游荡	遊蕩
游艺	遊藝
游蜂	遊蜂
游行	遊行
游街	遊街
游览	遊覽
游观	遊觀
游记	遊記
游说	遊說
游豫	遊豫
游走	遊走
游踪	遊蹤
游军	遊軍
游逛	遊逛
游遍	遊遍
游错	遊錯
游非	游非
游非洲	遊非洲
游香	游香
游香港	遊香港
游骑	遊騎
游魂	遊魂
浑函	渾涵
涌卷	湧捲
湮郁	湮鬱
汤团	湯糰
汤面	湯麵
溜达	溜躂
溜须	溜須
溜须拍马	溜鬚拍馬
溪壑	谿壑
溶岩	熔岩
溶接	熔接
溶炉	熔爐
溶销	熔銷
溶铸	熔鑄
滴干	滴乾
滚卷	滾捲
满布	滿佈
漓水	灕水
漓江	灕江
漓湘	灕湘
汉周	漢周
漫游	漫遊
渍已	漬已
渍已干	漬已乾
渐愈	漸癒
渐松	漸鬆
浆划	槳劃
润发	潤髮
潦阔	遼闊
潮卷	潮捲
浇制	澆製
激干	激幹
激斗	激鬥
激荡	激盪
浓发	濃髮
浓纤	穠纖
湿发	濕髮
蒙松	濛鬆
滥征	濫徵
滥芋	濫芋
滥芋充数	濫竽充數
沥干	瀝乾
灌制	灌製
滩涂	灘塗
火折	火摺
火拼	火拚
火签	火籤
灰发	灰髮
灰尽	灰燼
灰胡	灰鬍
灰蒙	灰濛
灰郁	灰鬱
灸热	炙熱
炒干	炒乾
炒面	炒麵
炮制	炮製
炸毁	炸燬
为准	為準
为范	為範
乌丘	烏坵
乌发	烏髮
乌里	烏里
乌龙	烏龍
乌龙面	烏龍麵
烘制	烘製
烘干	烘乾
烘熏	烘燻
烤干	烤乾
烹制	烹製
焊接	銲接
焙干	焙乾
焚毁	焚燬
无余	無餘
无梁	無樑
无欲	無慾
无烟	無煙
无烟室	無菸室
无烟环境	無菸環境
无烟餐厅	無菸餐廳
无厘	無釐
无厘头	無厘頭
焦干	焦乾
然斗	然斗
然斗不	然鬥不
然无	然無
然无幸	然無倖
然象	然像
炼制	煉製
炼子	鍊子
炼锁	鍊鎖
煎制	煎製
烟卷	菸捲
烟商	菸商
烟客	菸客
烟枪	菸槍
烟民	菸民
烟没	湮沒
烟灰	菸灰
烟焦	煙焦
烟焦油	菸焦油
烟熏	煙燻
烟瘾	菸癮
烟草	菸草
烟酒	菸酒
烟头	菸頭
烟鬼	菸鬼
烟龄	菸齡
照准	照準
照干	照幹
照象	照像
煨干	煨乾
烦郁	煩鬱
煮面	煮麵
熏制	燻製
熏烟	燻煙
熏煮	燻煮
熏熏	燻燻
熏熟	燻熟
熏热	燻熱
熏肉	燻肉
熏蒸	燻蒸
熏猪	燻豬
熏鸭	燻鴨
熏鹅	燻鵝
熏黑	燻黑
荧光	螢光
荧屏	螢屏
荧幕	螢幕
荧郁	熒鬱
熔毁	熔燬
熨干	熨乾
熬制	熬製
灯彩	燈綵
燎发	燎髮
烧制	燒製
烧干	燒乾
烧毁	燒燬
燕游	燕遊
燕燕	燕燕
燕燕于飞	燕燕于飛
烫发	燙髮
烫面	燙麵
营干	營幹
烩制	燴製
烩干	燴乾
烬余	燼餘
争斗	爭鬥
片姜	片薑
片纸	片紙
片纸只字	片紙隻字
片言	片言
片言只语	片言隻語
牙签	牙籤
牛只	牛隻
牛柳	牛柳
牛柳面	牛柳麵
物志	物誌
物欲	物慾
牲干	牲干
牲干下	牲幹下
特制	特製
特征	特徵
牵一	牽一
牵一发	牽一髮
牵系	牽繫
犁牛	犛牛
犬只	犬隻
狂卷	狂捲
狂征	狂徵
狂冲	狂衝
狂赞	狂讚
狠、	狠、
狠、准	狠、準
狠且	狠且
狠且准	狠且準
狠又	狠又
狠又准	狠又準
狠干	狠幹
狠斗	狠鬥
狼借	狼藉
猛卷	猛捲
猛干	猛幹
猛斗	猛鬥
猛冲	猛衝
猜准	猜準
犹太	猶太
犹太历	猶太曆
猷豫	猶豫
奖杯	獎盃
独斗	獨鬥
独游	獨遊
独辟	獨闢
独辟蹊径	獨闢蹊徑
独钟	獨鍾
兽奸	獸姦
兽欲	獸慾
献丑	獻醜
玉佩	玉珮
玉制	玉製
王后	王后
玲胧	玲瓏
玻里	玻裡
玻里尼西	玻里尼西
现丑	現醜
现象	現象
球台	球檯
球果	毬果
球杆	球杆
球童	球僮
琅嬛	瑯嬛
琅当	琅璫
理发	理髮
琢制	琢製
琳琅	琳瑯
珐琅	琺瑯
瑞哲	睿哲
瑞智	睿智
瑶签	瑤籤
璀灿	璀璨
璨烂	燦爛
环佩	環珮
环游	環遊
瓶白	瓶白
瓶白干	瓶白乾
瓷制	瓷製
甘乃	甘乃
甘乃迪	甘迺迪
甘薯	甘藷
甚丑	甚醜
甚准	甚準
甚松	甚鬆
甚么	甚麼
甚么都干	甚麼都幹
甜面	甜面
甜面酱	甜麵醬
生克	生剋
生力	生力
生力面	生力麵
生姜	生薑
生得	生得
生得丑	生得醜
生理	生理
生发	生發
生发水	生髮水
生发药	生髮藥
生长	生長
甩发	甩髮
甲胄	甲冑
男用	男用
男用表	男用錶
留发	留髮
畛怀	軫懷
亩余	畝餘
略干	略乾
略松	略鬆
畦径	畦逕
番薯	蕃薯
画象	畫像
画饼	畫餅
画饼充饥	畫餅充饑
当一	當一
当一声	噹一聲
当其	當其
当其冲	當其衝
当准	當準
当周	當週
当周润发	當周潤發
当啷	噹啷
当局	當局
当年	當年
当然	當然
当然罗！	當然囉！
当当	噹噹
当当当	噹噹噹
当的	當的
当的一声	噹的一聲
当的一响	噹的一響
当郎	噹啷
疆弩	疆弩
疆弩之末	彊弩之末
疏松	疏鬆
疏浚	疏濬
疑系	疑係
疔伤	療傷
疲困	疲睏
疾卷	疾捲
疾冲	疾衝
病入	病入
病入膏盲	病入膏肓
病征	病徵
病愈	病癒
病难	病難
病难愈	病難癒
症结	癥結
痊愈	痊癒
痉孪	痙攣
发乳	髮乳
发乱	發亂
发乱钗横	髮亂釵橫
发冠	髮冠
发卷	髮捲
发型	髮型
发夹	髮夾
发套	髮套
发如	發如
发如飞蓬	髮如飛蓬
发妻	髮妻
发姐	髮姐
发布	發佈
发带	髮帶
发干	發乾
发廊	髮廊
发式	髮式
发指	髮指
发指令	發指令
发挽	發挽
发挽双髻	髮挽雙髻
发束	髮束
发根	髮根
发梢	髮梢
发梳	髮梳
发油	髮油
发皓	髮皓
发笺	髮箋
发箍	髮箍
发簪	髮簪
发丝	髮絲
发缨	髮纓
发肤	髮膚
发胶	髮膠
发色	髮色
发菜	髮菜
发蜡	髮蠟
发表	發表
发表欲	發表慾
发质	髮質
发辫	髮辮
发醅	醱醅
发针	髮針
发钗	髮釵
发长	髮長
发长音	發長音
发际	髮際
发雕	髮雕
发霜	髮霜
发面	發麵
发须	發須
发须俱	髮鬚俱
发须已	髮鬚已
发须斑	髮鬚斑
发须皆	髮鬚皆
发须都	髮鬚都
发饰	髮飾
发香	髮香
发髯	髮髯
发髻	髮髻
发鬓	髮鬢
发霉	發霉
白淅	白皙
白澈	白皙
白发	白髮
白白	白白
白白干	白白幹
白术	白朮
白面	白面
白面无须	白面無鬚
白须	白鬚
百余	百餘
百余只	百餘隻
百余里	百餘里
百只	百隻
百天	百天
百天后	百天後
百姓	百姓
百姓于	百姓於
百拙	百拙
百拙千丑	百拙千醜
百海	百海
百海里	百海里
百里	百里
的丑	的醜
的丑相	的醜相
的亮	的亮
的亮发	的亮髮
的发	的發
的发型	的髮型
的发式	的髮式
皆准	皆準
皆云	皆云
皇后	皇后
皇历	皇曆
皓发	皓髮
皮制	皮製
皮松	皮鬆
皱折	皺摺
盆吊	盆弔
盈余	盈餘
盍然	溘然
盍盍	溘溘
盍谢	溘謝
盍逝	溘逝
盛赞	盛讚
盗采	盜採
尽先	儘先
尽可	盡可
尽可能	儘可能
尽够	儘夠
尽干	盡幹
尽教	儘教
尽早	儘早
尽是	儘是
尽有	盡有
尽有可能	儘有可能
尽管	儘管
尽量	儘量
监制	監製
盘卷	盤捲
盘回	盤迴
盘涅	槃涅
盘游	盤遊
目定	目定
目定口呆	目瞪口呆
目我	目我
目我于思	目我于思
盯准	盯準
盲干	盲幹
盲冲	盲衝
直卷	直捲
直干	直幹
直冲	直衝
直发	直髮
直发抖	直發抖
直发毛	直發毛
直发汗	直發汗
相并	相併
相克	相剋
相准	相準
相奸	相姦
相干	相干
相形	相形
相形见拙	相形見絀
相拼	相拚
相斗	相鬥
相当	相當
相当准	相當準
相象	相像
相关	相關
眈误	耽誤
看不	看不
看不准	看不準
看准	看準
看出	看出
看出电影	看齣電影
看着	看著
真丑	真醜
真准	真準
真凶	真兇
真知	真知
真知卓见	真知灼見
真缔	真諦
真象	真像
真象科	真象科
眩耀	炫耀
眼困	眼睏
眼框	眼眶
眼花	眼花
眼花了乱	眼花瞭亂
睡眠	睡眠
睡眠欲	睡眠慾
瞄不	瞄不
瞄不准	瞄不準
瞄准	瞄準
瞅不	瞅不
瞅不准	瞅不準
瞅准	瞅準
瞌然	瞌然
瞌然长逝	溘然長逝
瞎冲	瞎衝
瞥准	瞥準
瞧不	瞧不
瞧不准	瞧不準
瞧准	瞧準
瞧着	瞧著
知丑	知醜
短小	短小
短小精干	短小精悍
短发	短髮
短发性	短發性
短须	短鬚
石制	石製
石梁	石樑
石膏	石膏
石膏象	石膏像
石英	石英
石英表	石英錶
石英钟	石英鍾
石象	石像
砌并	砌併
砍准	砍準
研制	研製
砰当	砰噹
破坏	破壞
破坏欲	破壞慾
硬干	硬幹
硬拼	硬拚
硬冲	硬衝
硬发	硬髮
碎发	碎髮
碑志	碑誌
碗干	碗乾
碗白	碗白
碗白干	碗白乾
碗素	碗素
碗素面	碗素麵
碗面	碗麵
碧咸	碧咸
确系	確係
确系着	確繫著
磁制	磁製
磋跎	蹉跎
磨制	磨製
示范	示範
神佑	神祐
神准	神準
神只	神祇
神游	神遊
神祗	神祇
神经	神經
神经干	神經幹
神象	神像
神迹	神蹟
祭吊	祭弔
禁欲	禁慾
禁烟	禁菸
禁若	禁若
禁若寒蝉	噤若寒蟬
礼赞	禮讚
秃发	禿髮
秀发	秀髮
私下	私下
私下里	私下裡
私斗	私鬥
私欲	私慾
秋不	秋不
秋不干	秋不乾
秋千	鞦韆
秋台	秋颱
秋游	秋遊
秒表	秒錶
秘制	秘製
租贷	租賃
秤锤	秤錘
稀松	稀鬆
稀里	稀里
稍干	稍干
稍干的	稍乾的
稍有	稍有
稍有不准	稍有不準
稍松	稍鬆
禀复	稟覆
种师	種師
种师中	种師中
种师道	种師道
种放	种放
种发	種發
种发式	種髮式
种谷	種穀
称赞	稱讚
稻杆	稻稈
稻谷	稻穀
稽康	嵇康
稽征	稽徵
积淀	積澱
积谷	積穀
积郁	積鬱
稳且	穩且
稳且准	穩且準
稳扎	穩紮
稳稳	穩穩
稳稳当当	穩穩當當
空余	空餘
空蒙	空濛
穿着	穿著
窒欲	窒慾
窗台	窗檯
窣悉	窣窸
窝里	窩裡
窝里斗	窩裡鬥
窥准	窺準
竟斗	竟斗
竟斗不	竟鬥不
竟象	竟像
童仆	僮僕
童婢	僮婢
竞斗	競鬥
竹制	竹製
竹席	竹蓆
竹框	竹筐
竹杆	竹竿
竹签	竹籤
竹荀	竹筍
竹藤	竹籐
竽头	芋頭
笆蕉	芭蕉
笑容	笑容
笑容可鞠	笑容可掬
笑讷	笑納
笑魇	笑靨
符录	符籙
笔秃	筆禿
笔秃墨干	筆禿墨乾
等侯	等候
筋斗	觔斗
笋干	筍乾
笋况	荀況
答复	答覆
策勋	策勛
算不	算不
算不准	算不準
算丑	算醜
算准	算準
管理	管理
箱函	箱涵
节余	節餘
节欲	節慾
篷松	篷鬆
篾箪	篾簟
简朴	簡樸
箫条	蕭條
签卜	籤卜
签文	籤文
签条	籤條
签爪	籤爪
签筒	籤筒
签诗	籤詩
籍口	藉口
箩卜	蘿蔔
吁了	吁了
吁俞	吁俞
吁咈	吁咈
吁嗟	吁嗟
吁叹	吁嘆
吁嘘	吁噓
吁气	吁氣
吁吁	吁吁
米余	米餘
米谷	米穀
粉制	粉製
粉干	粉乾
粗制	粗製
粗朴	粗樸
精准	精準
精制	精製
精干	精幹
精致	精緻
精辟	精闢
糊口	餬口
糊涂	糊塗
糟塌	糟蹋
糟达	蹧躂
糟遢	糟蹋
糸于	糸於
糸于一线	繫於一線
系一	系一
系一片	係一片
系一番	係一番
系一种	係一種
系一线	繫一線
系上	繫上
系乎	繫乎
系了	繫了
系住	繫住
系个	繫個
系囚	繫囚
系块	繫塊
系妥	繫妥
系带	繫帶
系引	係引
系心	繫心
系念	繫念
系怀	繫懷
系手	繫手
系指	係指
系挂	繫掛
系数	係數
系于	繫於
系于一发	繫於一髮
系条	繫條
系为	係為
系争	係爭
系牢	繫牢
系获	係獲
系留	繫留
系发	系發
系发带	繫髮帶
系累	係累
系绊	繫絆
系丝	系絲
系丝带	繫絲帶
系紧	繫緊
系缚	繫縛
系绳	繫繩
系缆	繫纜
系腰	繫腰
系脚	繫腳
系膜	繫膜
系着	繫著
系裹	繫裹
系裤	系褲
系裤子	繫褲子
系起	繫起
系踵	係踵
系辞	繫辭
系铃	繫鈴
系铃人	繫鈴人
系鞋	系鞋
系鞋带	繫鞋帶
系头	系頭
系头巾	繫頭巾
系颈	繫頸
系颈阙庭	係頸闕庭
系风	系風
系风捕景	係風捕景
系马	繫馬
纪念	紀念
纪念周	紀念週
纪历	紀曆
约斗	約鬥
约雇	約僱
红签	紅籤
红须	紅須
红须绿眼	紅鬚綠眼
纡余	紆餘
纡回	紆迴
纡郁	紆鬱
纨绔	紈袴
纨绔子弟	紈褲子弟
纨袴	紈褲
纳征	納徵
纯朴	純樸
纯系	純係
纸扎	紙紮
素朴	素樸
素食	素食
素食面	素食麵
纺锤	紡錘
索马	索馬
索马利里	索馬利里
索马里	索馬里
索马里兰	索馬里蘭
紫姜	紫薑
累累	纍纍
细致	細緻
结伙	結夥
结余	結餘
结彩	結綵
结扎	結紮
结发	結髮
绞干	絞乾
给他	給他
给他干粮	給他乾糧
给你	給你
给你干粮	給你乾糧
给她	給她
给她干粮	給她乾糧
给我	給我
给我干净	給我乾淨
丝制	絲製
丝弦	絲絃
绑扎	綁紮
经斗	經斗
经斗数	經鬥數
经理	經理
经白	經白
经白干	經白幹
综合	綜合
综合征	綜合徵
绸密	稠密
维系	維繫
绾发	綰髮
网志	網誌
网游	網遊
紧卷	緊捲
紧扎	緊紮
绪余	緒餘
缉凶	緝兇
编发	編髮
编篡	編纂
编采	編採
缓征	緩徵
缓冲	緩衝
缈茫	渺茫
萦回	縈迴
缜致	縝緻
县志	縣誌
缝制	縫製
缝扎	縫紮
缝纴	縫紉
缩栗	縮慄
纵横	縱橫
纵横交布	縱橫交佈
纵欲	縱慾
縻系	縻繫
总理	總理
繁复	繁複
绕梁	繞樑
绣象	繡像
绘制	繪製
继续	繼續
继续干	繼續幹
纂位	篡位
续弦	續絃
缠卷	纏捲
缠斗	纏鬥
纤夫	縴夫
缺舌	鴃舌
罔然	惘然
罔罔	惘惘
罩准	罩準
罩卷	罩捲
罢斗	罷鬥
罗哩	囉哩
罗唆	囉唆
罗嗦	囉嗦
罗啰	囉囉
罗啰唆唆	囉囉唆唆
罗啰嗦嗦	囉囉嗦嗦
罗罗	羅羅
罗罗苏苏	囉囉囌囌
罗苏	囉囌
罗里	羅里
罗里啰唆	囉哩囉唆
罗里啰嗦	囉哩囉嗦
罗里罗苏	囉哩囉囌
罗难	罹難
罗音	囉音
羁拌	羈絆
美丑	美醜
美制	美製
美制定	美制定
美制订	美制訂
美或	美或
美或丑	美或醜
美与	美與
美与丑	美與醜
羞赦	羞赧
羡余	羨餘
群斗	群鬥
群象	群像
羹面	羹麵
翕辟	翕闢
翦彩	翦綵
翱游	翱遊
翻来	翻來
翻来复去	翻來覆去
翻卷	翻捲
翻台	翻檯
翻松	翻鬆
翻云	翻雲
翻云复雨	翻雲覆雨
老丑	老醜
老且	老且
老且丑	老且醜
老姜	老薑
老板	老闆
老么	老么
考征	考徵
者系	者係
者云	者云
而云	而云
而云然云	而云然
而云尔云	而云爾
而云诗云	而云詩
而象	而像
耐心	耐心
耐心细致	耐心細緻
耕获	耕穫
耗干	耗乾
聊天	聊天
聊斋	聊齋
聊斋志异	聊齋誌異
圣叹	聖歎
圣杯	聖盃
圣象	聖像
圣迹	聖蹟
聘雇	聘僱
联准	聯准
联准局	聯準局
联征	聯徵
联手	聯手
联手斗	聯手鬥
联系	聯繫
联系统	聯系統
听不	聽不
听不准	聽不準
听着	聽著
肆业	肄業
肉干	肉乾
肉松	肉鬆
肉欲	肉慾
肉丝	肉絲
肉丝面	肉絲麵
肉面	肉麵
肖象	肖像
肝脏	肝臟
股栗	股慄
肢体	肢體
肯干	肯幹
肯干啊	肯幹啊
肴撰	餚饌
肺脏	肺臟
胃脏	胃臟
背影	背影
背影后	背影後
背系	背繫
胡子	鬍子
胡干	胡幹
胡梢	鬍梢
胡涂	胡塗
胡渣	鬍渣
胡碴	胡碴
胡碴子	鬍碴子
胡里	胡裡
胡里胡涂	糊裡糊塗
胡雪	胡雪
胡雪岩	胡雪巖
胡须	鬍鬚
胡髭	鬍髭
胡髯	鬍髯
胡鬓	鬍鬢
胰脏	胰臟
能干	能幹
能干休	能干休
能干嚎	能乾嚎
能干巴巴	能乾巴巴
能干搁	能乾擱
能干扰	能干擾
能干政	能干政
能干杯	能乾杯
能干涉	能干涉
能干净	能乾淨
能干瞪	能乾瞪
能干笑	能乾笑
能干系	能干系
能干耗	能乾耗
能干脆	能乾脆
能乾着急	能乾著急
能干预	能干預
能舍	能捨
能象	能像
能象征	能象徵
能象征性	能象徵性
脉冲	脈衝
脊梁	脊樑
唇干	脣乾
脱发	脫髮
脺脏	脺臟
脾脏	脾臟
肾脏	腎臟
腐余	腐餘
腑脏	腑臟
腕表	腕錶
脑干	腦幹
腮胡	腮鬍
腰一	腰一
腰一卷	腰一捲
腰干	腰幹
腰系	腰繫
腰间	腰間
腰间系	腰間繫
脚夫	腳伕
脚注	腳註
脚炼	腳鍊
肠脏	腸臟
胶制	膠製
膨松	膨鬆
膺品	贗品
胆战	膽顫
臂一	臂一
臂一卷	臂一捲
卧游	臥遊
自助	自助
自助游	自助遊
自愈	自癒
自赞	自讚
自采	自採
致密	緻密
舂谷	舂穀
舄湖	潟湖
与他	與他
与他一斗	與他一鬥
与女	與女
与女斗	與女鬥
与她	與她
与她一斗	與她一鬥
旧历	舊曆
旧历史	舊歷史
旧游	舊遊
舌一	舌一
舌一卷	舌一捲
舍下	舍下
舍下他	捨下他
舍下你	捨下你
舍下她	捨下她
舍下我	捨下我
舍不	舍不
舍不得	捨不得
舍出	捨出
舍去	捨去
舍命	捨命
舍己	捨己
舍得	捨得
舍我	舍我
舍我其谁	捨我其誰
舍本	捨本
舍弃	捨棄
舍死	捨死
舍生	捨生
舍短	捨短
舍旧	舍舊
舍旧迎新	捨舊迎新
舍身	捨身
舍车	舍車
舍车保帅	捨車保帥
舍近	捨近
舒卷	舒捲
舒宁	舒寧
舒宁咸	舒寧咸
舔干	舔乾
舞卷	舞捲
舞娘	舞孃
舞后	舞后
舟揖	舟楫
航海	航海
航海历	航海曆
般准	般準
舶船	泊船
船只	船隻
船夫	船伕
船梁	船樑
船浆	船槳
船纤	船縴
船蓬	船篷
舰只	艦隻
艨冲	艨衝
良游	良遊
色欲	色慾
花卷	花捲
花发	花發
花发老	花髮老
花雕	花彫
苛征	苛徵
若干	若干
若象	若像
苦干	苦幹
苦斗	苦鬥
苦瓜	苦瓜
苦瓜干	苦瓜乾
英九	英九
英寸	英吋
英尺	英呎
英里	英里
范不	范不
范不着	範不著
范例	範例
范围	範圍
范式	範式
范文	範文
范本	範本
范畴	範疇
范行	範行
范险	範險
茅芦	茅廬
茶余	茶餘
茶已	茶已
茶已干	茶已乾
茶干	茶干
茶干掉	荼乾掉
茶干尽	茶乾盡
茶几	茶几
茶毒	荼毒
茶卤	茶滷
草席	草蓆
草管	草管
草管人命	草菅人命
荆朴	荊璞
荷里	荷裡
荷里活	荷里活
莒光	莒光
莒光周	莒光週
茎干	莖幹
莫明	莫明
莫明其妙	莫名其妙
莫里	莫里
菜干	菜乾
菜肴	菜餚
华里	華裡
华里沙	華里沙
万余	萬餘
万余只	萬餘隻
万余里	萬餘里
万只	萬隻
万只怕	萬只怕
万历	萬曆
万海	萬海
万海里	萬海里
万里	萬里
落发	落髮
叶里	葉裡
叶里温	葉里溫
着干	著幹
葡萄	葡萄
葡萄干	葡萄乾
蒙住	矇住
蒙叟	矇叟
蒙懂	懞懂
蒙敝	矇蔽
蒙昧	矇昧
蒙胧	矇矓
蒙冲	蒙衝
蒙混	矇混
蒙瞀	矇瞀
蒙瞢	矇瞢
蒙瞽	矇瞽
蒙眬	矇矓
蒙蒙	濛濛
蒙蒙胧	朦朦朧
蒙蒙胧胧	矇矇矓矓
蒙蒙眬	矇矇矓
蒙蔽	矇蔽
蒙雾	濛霧
蒙骗	矇騙
蒲席	蒲蓆
蒸干	蒸乾
苍术	蒼朮
苍郁	蒼鬱
蓄发	蓄髮
蓄须	蓄鬚
蓊郁	蓊鬱
蓬松	蓬鬆
蓬发	蓬髮
蓬蓬	蓬蓬
蓬蓬松松	蓬蓬鬆鬆
蒋干	蔣幹
葱郁	蔥鬱
荫郁	蔭鬱
荡口	盪口
荡气	蕩氣
荡气回肠	蕩氣迴腸
荡气回阳	蕩氣迴陽
荡秋	蕩秋
荡秋千	盪鞦韆
荡舟	盪舟
荡开	盪開
薄幸	薄倖
荐饥	薦饑
藤制	藤製
藤条	籐條
藤椅	籐椅
药制	藥製
药签	藥籤
药而	藥而
药而愈	藥而癒
苏里	蘇里
苏醒	甦醒
蕴借	蘊藉
蕴函	蘊涵
蕴酿	醞釀
萝卜	蘿蔔
萝卜干	蘿蔔乾
虎咽	虎嚥
虎斗	虎鬥
虎须	虎鬚
处理	處理
处高	處高
处高务远	處高鶩遠
虚象	虛像
号志	號誌
虬须	虯鬚
蛋卷	蛋捲
蛩音	跫音
虱目	虱目
蟹螫	蟹螯
蜡象	蠟像
蛮准	蠻準
蛮干	蠻幹
蛮干净	蠻乾淨
蛮干燥	蠻乾燥
蛮干爽	蠻乾爽
血已	血已
血已干	血已乾
血才	血才
血才干	血才乾
血斗	血鬥
行事	行事
行事历	行事曆
行凶	行兇
行尸	行尸
行李	行李
行李卷	行李捲
行游	行遊
衣物	衣物
衣物已干	衣物已乾
衣物渐干	衣物漸乾
衣衫	衣衫
衣衫已干	衣衫已乾
衣驱	衣袪
表带	錶帶
表店	錶店
表厂	錶廠
表征	表徵
表壳	錶殼
表演	表演
表演欲	表演慾
表炼	錶鏈
表范	表範
表链	錶鏈
衫毕	衫畢
衫毕挺	衫筆挺
袖一	袖一
袖一卷	袖一捲
被并	被併
被卷	被捲
被干	被幹
被干扰	被干擾
被干涉	被干涉
被干预	被干預
被复	被覆
被发	被發
被发左衽	被髮左衽
被褥	被縟
裁并	裁併
裁制	裁製
袅雄	梟雄
裕余	裕餘
裙摆	裙襬
补注	補註
装璜	裝潢
里亚	里亞
里仁	里仁
里余	裡餘
里士	裡士
里士满	里士滿
里夫	里夫
里奥	里奧
里尼	里尼
里布	里布
里拉	里拉
里斯	裡斯
里斯本	里斯本
里昂	里昂
里根	里根
里民	里民
里尔	里爾
里科	里科
里程	里程
里约	里約
里纳	里納
里美	里美
里肌	里肌
里兰	里蘭
里象	裡像
里路	里路
里里	里奇
里长	里長
里面	裡面
里面冲	裡面衝
里面冲水	裡面沖水
里面冲洗	裡面沖洗
里面冲凉	裡面沖涼
里面冲澡	裡面沖澡
里面冲身	裡面沖身
裹尸	裹尸
裹扎	裹紮
褐发	褐髮
亵读	褻瀆
襁保	襁褓
褴缕	襤褸
袭卷	襲捲
西周	西周
西岳	西嶽
西后	西后
西昆	西崑
西历	西曆
西冲	西衝
西游	西遊
西装	西裝
西装毕挺	西裝筆挺
西里	西里
要丑	要丑
要丑上	要醜上
要干	要干
要干了	要乾了
要干什么	要幹什麼
要干嘛	要幹嘛
要干杯	要乾杯
要斗	要鬥
要冲	要衝
要冲厕	要沖廁
要冲水	要沖水
要冲凉	要沖涼
要象	要像
规划	規劃
规模	規模
规范	規範
觅准	覓準
亲自	親自
亲自干	親自幹
觊幸	覬倖
觑准	覷準
观斗	觀鬥
观采	觀採
角斗	角鬥
角落	角落
解签	解籤
解签约	解簽約
解象	解像
解雇	解僱
觞子	殤子
触须	觸鬚
订制	訂製
计准	計準
评击	抨擊
评注	評註
词余	詞餘
词汇	詞彙
咏叹	詠歎
试卷	試卷
诗余	詩餘
诗云	詩云
话云	話云
该像	該像
该像征	該象徵
该象	該像
详征	詳徵
详注	詳註
夸克	夸克
夸克星	夸克星
夸父	夸父
夸尔	夸爾
夸特	夸特
夸脱	夸脫
夸赞	誇讚
认丑	認醜
认准	認準
诱奸	誘姦
诱欲	誘慾
诱发	誘發
诱发型	誘發型
语汇	語彙
语云	語云
诚征	誠徵
诚朴	誠樸
诬蔑	誣衊
误冲	誤衝
说不	說不
说不准	說不準
说干	說干
说干便干	說幹便幹
说干就干	說幹就幹
说得	說得
说得个准	說得個準
说的	說的
说的准	說的準
说签	說籤
谁干	誰幹
谁干净	誰乾淨
谁干脆	誰乾脆
谁是	誰是
谁是于	誰是于
课余	課餘
课征	課徵
调准	調準
调制	調製
调制解调	調制解調
调松	調鬆
请托	請託
诸余	諸餘
诸候	諸侯
谚云	諺云
谋干	謀幹
谬赞	謬讚
謷丑	謷醜
哗啦	嘩啦
哗喇	嘩喇
哗的	譁的
哗的一声	嘩的一聲
哗哗	嘩嘩
警剔	警惕
译注	譯註
护发	護髮
读取	讀取
读取头	讀取頭
读写	讀寫
读写头	讀寫頭
变丑	變醜
变征	變徵
变松	變鬆
谶悔	懺悔
谷仓	穀倉
谷场	穀場
谷子	穀子
谷壳	穀殼
谷物	穀物
谷皮	穀皮
谷神	穀神
谷稻	穀稻
谷米	穀米
谷粉	穀粉
谷粒	穀粒
谷粟	穀粟
谷舱	穀艙
谷苗	穀苗
谷草	穀草
谷贱	穀賤
谷道	穀道
谷雨	穀雨
谷类	穀類
谷麦	穀麥
豁上	豁上
豁上干	豁上幹
豁出	豁出
豁出命干	豁出命幹
豁命	豁命
豁命干	豁命幹
豁壑	谿壑
豁死	豁死
豁死干	豁死幹
豁起	豁起
豁起来干	豁起來幹
豆制	豆製
豆腐	豆腐
豆腐干	豆腐乾
豆蔻	荳蔻
豆鼓	豆豉
丰姿	丰姿
丰度	丰度
丰情	丰情
丰神	丰神
丰谀	豐腴
丰韵	丰韻
艳后	豔后
象一	像一
象三	像三
象不	象不
象不像	像不像
象之	象之
象之前	像之前
象二	像二
象些	像些
象人	像人
象什	像什
象今	像今
象他	像他
象以	象以
象以前	像以前
象以往	像以往
象似	像似
象你	像你
象个	像個
象两	像兩
象其	像其
象别	像別
象刚	像剛
象吗	像嗎
象在	像在
象梦	像夢
象她	像她
象它	像它
象已	像已
象带	像帶
象平	象平
象平时	像平時
象往	像往
象征	象徵
象征战	像征戰
象征服	像征服
象您	像您
象我	像我
象所	象所
象所有	像所有
象昨	像昨
象是	像是
象有	像有
象极	像極
象样	像樣
象水	像水
象永	像永
象片	像片
象牙	象牙
象牙齿	像牙齒
象现	像現
象甚	像甚
象当	像當
象疯	像瘋
象素	像素
象自	象自
象自己	像自己
象要	像要
象话	像話
象谁	像誰
象赞	像贊
象这	像這
象过	象過
象过去	像過去
象那	像那
象银	像銀
象雨	像雨
象风	像風
象鬼	像鬼
象么	像麼
豪华	豪華
豪华游	豪華遊
猪只	豬隻
猪肝	豬肝
猪肝面	豬肝麵
猪脚	豬腳
猪脚面	豬腳麵
猪舌	豬舌
猪舌面	豬舌麵
貌丑	貌醜
贝胄	貝冑
贝里	貝里
财欲	財慾
贪欲	貪慾
贵干	貴幹
买凶	買兇
买姜	買薑
买烟	買菸
贴志	貼誌
贴着	貼著
赈饥	賑饑
赐复	賜覆
卖奸	賣姦
卖姜	賣薑
质朴	質樸
赌台	賭檯
赌台湾	賭台灣
赌斗	賭鬥
剩余	賸餘
购并	購併
购并不	購並不
购并且	購並且
购并非	購並非
购买	購買
购买欲	購買慾
赞一	贊一
赞一句	讚一句
赞一声	讚一聲
赞一赞	讚一讚
赞不	贊不
赞不绝口	讚不絕口
赞了	讚了
赞他	讚他
赞仰	讚仰
赞你	讚你
赞佩	讚佩
赞个	贊個
赞个不	讚個不
赞两	贊兩
赞两句	讚兩句
赞口	贊口
赞口不	讚口不
赞叹	讚歎
赞她	讚她
赞好	讚好
赞妙	讚妙
赞得	讚得
赞您	讚您
赞我	讚我
赞捧	讚捧
赞扬	讚揚
赞乐	讚樂
赞歌	讚歌
赞的	讚的
赞美	讚美
赞羡	讚羨
赞羡	讚羨
赞声	讚聲
赞自	贊自
赞自己	讚自己
赞着	讚著
赞许	讚許
赞词	讚詞
赞咏	讚詠
赞诵	讚誦
赞誉	讚譽
赞赏	讚賞
赞辞	讚辭
赞这	讚這
赞过	讚過
赞道	讚道
赞那	讚那
赞颂	讚頌
赞：	讚：
赢余	贏餘
赤坎	赤崁
赤发	赤髮
起来	起來
起来象	起來像
起哄	起鬨
起干	起幹
超征	超徵
越丑	越醜
越准	越準
越咸	越鹹
越斗	越鬥
越象	越像
赶制	趕製
趋之	趨之
趋之若务	趨之若鶩
跌冲	跌衝
跖骨	蹠骨
跟他	跟他
跟他一斗	跟他一鬥
跟他斗	跟他鬥
跟你	跟你
跟你斗	跟你鬥
跟女	跟女
跟女斗	跟女鬥
跟她	跟她
跟她斗	跟她鬥
跟我	跟我
跟我斗	跟我鬥
跟斗	觔斗
跟跄	踉蹌
路签	路籤
路里	路里
跳只	跳只
跳只舞	跳隻舞
跳梁	跳樑
跳表	跳錶
踅门	踅門
踅门了户	踅門瞭戶
践道	棧道
踢踏	踢踏
踢踏舞	踢躂舞
蹉陀	蹉跎
蹒顸	顢頇
躁郁	躁鬱
身分	身份
身系	身繫
躬敬	恭敬
躯干	軀幹
车夫	車伕
车游	車遊
轨范	軌範
轩辟	軒闢
轫性	韌性
软发	軟髮
轸域	畛域
较丑	較醜
较像	較像
较像征	較象徵
较准	較準
较斗	較鬥
较松	較鬆
较象	較像
轻台	輕颱
轻挑	輕佻
轻松	輕鬆
轻篾	輕蔑
轻轻	輕輕
轻轻松松	輕輕鬆鬆
辈子	輩子
辈子干	輩子幹
轮回	輪迴
轮奸	輪姦
轮流	輪流
轮流干	輪流幹
辑凶	輯兇
转寰	轉圜
转戾	轉戾
转戾点	轉捩點
转托	轉託
轿夫	轎伕
辟佛	闢佛
辟作	闢作
辟划	闢劃
辟土	闢土
辟地	闢地
辟室	闢室
辟建	闢建
辟为	闢為
辟田	闢田
辟筑	闢築
辟谣	闢謠
辟谬	闢謬
辟谷	辟榖
辟蹊	辟蹊
辟蹊径	闢蹊徑
辟透	闢透
辟邪	闢邪
辟门	辟門
辟门户	闢門戶
辟阖	闢闔
辣面	辣麵
辨奸	辨奸
辨奸论	辨姦論
辞汇	辭彙
辫发	辮髮
农历	農曆
农民	農民
农民历	農民曆
农获	農穫
迂回	迂迴
迎斗	迎鬥
迥廊	迴廊
迥避	迴避
迨尽	殆盡
迷奸	迷姦
迷朦	迷濛
迷罔	迷惘
迷蒙	迷濛
迷迷	迷迷
迷迷蒙蒙	迷迷濛濛
迻逦	迆邐
追凶	追兇
追朔	追溯
追根	追根
追根究抵	追根究柢
追谥	追諡
透辟	透闢
这伙	這伙
这伙人	這夥人
这出	這出
这出剧	這齣劇
这出好戏	這齣好戲
这出戏	這齣戲
这出电影	這齣電影
这般	這般
这般准	這般準
这般干法	這般幹法
这里	這裡
这么	這麼
这么丑	這麼醜
这么像征	這麼象徵
这么准	這麼準
这么干	這麼幹
通奸	通姦
通心	通心
通心面	通心麵
通浚	通濬
通谍	通牒
通辑	通緝
逞凶	逞兇
速干	速乾
速食	速食
速食面	速食麵
造象	造像
连杰	連杰
连卷	連捲
连抉	連袂
连斗	連鬥
连系	連繫
连系统	連系統
连络	聯絡
逼奸	逼姦
逾年	踰年
逾矩	踰矩
逾越	踰越
逾闲	踰閒
遇着	遇著
运筹	運籌
运筹惟幄	運籌帷幄
遍布	遍佈
过松	過鬆
遐疵	瑕疵
道坎	道檻
道里	道里
道赞	道讚
递回	遞迴
远扬	遠颺
远游	遠遊
遨游	遨遊
遮丑	遮醜
选准	選準
遗撼	遺憾
遗范	遺範
遗象	遺像
遗迹	遺蹟
辽亮	嘹喨
辽沈	遼瀋
邀天	邀天
邀天之幸	邀天之倖
邀斗	邀鬥
邂怠	懈怠
还丑	還醜
还要	還要
还要丑	還要醜
还象	還像
还象征服	還像征服
边斗	邊斗
边斗边	邊鬥邊
邋塌	邋遢
邋蹋	邋遢
那伙	那伙
那伙人	那夥人
那出	那出
那出剧	那齣劇
那出好戏	那齣好戲
那出戏	那齣戲
那出电影	那齣電影
那只	那隻
那只不过	那只不過
那只占	那只佔
那只剩	那只剩
那只加	那只加
那只在	那只在
那只增	那只增
那只多了	那只多了
那只够	那只夠
那只好	那只好
那只差	那只差
那只是	那只是
那只会	那只會
那只有	那只有
那只减	那只減
那只缺	那只缺
那只能	那只能
那只要	那只要
那只需	那只需
那般	那般
那般准	那般準
那里	那裡
那么	那麼
那么丑	那麼醜
那么准	那麼準
那么干	那麼幹
邪欲	邪慾
郁卒	鬱卒
郁堙	鬱堙
郁塞	鬱塞
郁垒	鬱壘
郁巍	鬱巍
郁律	鬱律
郁怒	鬱怒
郁悒	鬱悒
郁闷	鬱悶
郁愤	鬱憤
郁抑	鬱抑
郁挹	鬱挹
郁于	鬱於
郁暗	鬱暗
郁林	鬱林
郁沈	鬱沈
郁沉	鬱沉
郁泱	鬱泱
郁火	鬱火
郁热	鬱熱
郁燠	鬱燠
郁症	鬱症
郁痛	鬱痛
郁积	鬱積
郁纡	鬱紆
郁结	鬱結
郁蓊	鬱蓊
郁血	鬱血
郁邑	鬱邑
郁郁	鬱鬱
郁金	郁金
郁金香	鬱金香
郁闭	鬱閉
郁黑	鬱黑
郊游	郊遊
郎铛	啷鐺
部落	部落
郭朴	郭璞
都肯	都肯
都肯干	都肯幹
都舍	都舍
都舍下	都捨下
都象	都像
乡里	鄉里
乡愿	鄉愿
乡愿意	鄉願意
郑凯	鄭凱
郑凯云	鄭凱云
邻里	鄰里
配制	配製
配膳	配膳
配膳台	配膳檯
酒一	酒一
酒一坛	酒一罈
酒坛	酒罈
酒已	酒已
酒已干	酒已乾
酒干	酒干
酒干了	酒乾了
酒干掉	酒乾掉
酒干尽	酒乾盡
酒曲	酒麴
酒肴	酒餚
酣斗	酣鬥
酥松	酥鬆
酬佣	酬佣
酸疼	痠疼
酸痛	痠痛
酸软	痠軟
腌制	醃製
腌臜	腌臢
醇朴	醇樸
醋坛	醋罈
酱面	醬麵
醮墨	蘸墨
酿制	釀製
采伐	採伐
采供	採供
采信	採信
采光	採光
采卵	採卵
采取	採取
采写	採寫
采拾	採拾
采挖	採挖
采掘	採掘
采摘	採摘
采摭	採摭
采择	採擇
采撷	採擷
采收	採收
采桑	採桑
采梅	採梅
采样	採樣
采樵	採樵
采树	採樹
采检	採檢
采水	採水
采油	採油
采煤	採煤
采获	採獲
采猎	採獵
采珠	採珠
采生	採生
采用	採用
采石	採石
采硫	採硫
采矿	採礦
采种	採種
采稿	採稿
采粉	採粉
采精	採精
采纳	採納
采编	採編
采花	採花
采芹	採芹
采茶	採茶
采草	採草
采莲	採蓮
采薇	採薇
采药	採藥
采蜜	採蜜
采血	採血
采行	採行
采补	採補
采计	採計
采访	採訪
采认	採認
采证	採證
采买	採買
采购	採購
采办	採辦
采选	採選
采金	採金
采录	採錄
采集	採集
采风	采風
采风力	採風力
采食	採食
采饵	採餌
采验	採驗
重复	重複
重托	重託
重涂	重塗
重游	重遊
重檐	重檐
野游	野遊
金仑	金崙
金杯	金盃
金橘	金桔
金象	金象
金象奖	金像獎
钉槌	釘鎚
针炙	針灸
针黹	鍼黹
钓游	釣遊
钗环	釵鐶
钳制	箝制
钳口	箝口
铅锤	鉛錘
铰炼	鉸鍊
银制	銀製
银须	銀鬚
铜制	銅製
铜象	銅像
衔土	啣土
衔泥	啣泥
衔环	啣環
衔草	啣草
销溶	銷鎔
铝制	鋁製
铺位	舖位
钢制	鋼製
钢梁	鋼樑
录制	錄製
录影	錄影
录影后	錄影後
录象	錄像
锱衣	緇衣
钱钟	錢鐘
钱钟书	錢鍾書
锦镖	錦標
锡制	錫製
锡坤	錫堃
锻炼	鍛鍊
锻羽	鎩羽
锻链	鍛鍊
钟山	鍾山
锁炼	鎖鍊
锁碎	瑣碎
锤炼	錘煉
铠胄	鎧冑
铲刈	剷刈
铲去	剷去
铲平	剷平
铲灭	剷滅
铲起	剷起
铲除	剷除
镜象	鏡像
钟不	鍾不
钟情	鍾情
钟意	鍾意
钟爱	鍾愛
钟欣	鐘欣
钟欣桐	鍾欣桐
钟无	鐘無
钟无艳	鍾無艷
钟表	鐘錶
钟表态	鍾表態
钟表明	鍾表明
钟表决	鍾表決
钟表演	鐘表演
钟表现	鐘表現
钟表示	鍾表示
钟表露	鍾表露
钟表面	鐘錶面
钟馗	鍾馗
铁制	鐵製
铁槌	鐵鎚
铁炼	鐵鍊
铁练	鐵鍊
镶制	鑲製
镶崁	鑲嵌
长台	長檯
长得	長得
长得丑	長得醜
长发	長發
长发布	長發布
长发邨	長發邨
长吁	長吁
长象	長像
长须	長鬚
门坎	門檻
门斗	門鬥
门梁	門樑
闪铄	閃爍
开征	開徵
开浚	開濬
开发	開發
开辟	開闢
开采	開採
开铺	開舖
闲余	閒餘
闲游	閒遊
闲遐	閒暇
闲静	閑靜
间不	間不
间不容发	間不容髮
闺范	閨範
阃范	閫範
阖家	閤家
阖府	閤府
阖府上下	閤府上下
关注	關注
关系	關係
关系统	關系統
防台	防颱
防台湾	防台灣
防御	防禦
防水	防水
防水表	防水錶
防碍	妨礙
防范	防範
防饥	防饑
阿腴	阿諛
阿里	阿里
陀手	舵手
陀表	陀錶
附注	附註
限制	限制
陡松	陡鬆
陪吊	陪弔
陪着	陪著
阴干	陰乾
阴历	陰曆
阴郁	陰鬱
陷井	陷阱
阳春	陽春
阳春面	陽春麵
阳历	陽曆
隆准	隆準
隔周	隔週
雄赳	雄赳
雄赳赳	雄糾糾
雅致	雅緻
雅范	雅範
集团	集團
集游	集游
集游法	集遊法
雇不	雇不
雇不起	僱不起
雇主	僱主
雇人	僱人
雇佣	僱傭
雇员	僱員
雇役	僱役
雇有	僱有
雇用	僱用
雇舟	僱舟
雇船	僱船
雇请	僱請
雇车	僱車
雇农	僱農
雇马	僱馬
雕丧	彫喪
雕梁	雕樑
雕残	彫殘
雕落	彫落
雕虫	彫蟲
雕谢	彫謝
雕象	雕像
雕零	彫零
虽然	雖然
虽然丑	雖然醜
双并	雙併
双周	雙週
双斗	雙鬥
杂志	雜誌
鸡只	雞隻
鸡奸	雞姦
鸡丝	雞絲
鸡丝面	雞絲麵
鸡腿	雞腿
鸡腿面	雞腿麵
难咽	難嚥
难干	難乾
难斗	難斗
难斗的	難鬥的
难舍	難捨
云吞	雲吞
云吞面	雲吞麵
云宵	雲霄
云游	雲遊
云尔	云爾
云云	云云
云：	云：
电子	電子
电子表	電子錶
电子表单	電子表單
电子表情	電子表情
电子表格	電子表格
电子表示	電子表示
电子钟	電子鐘
电影	電影
电影后	電影後
电杆	電杆
电线	電線
电线杆	電線杆
震松	震鬆
震栗	震慄
震荡	震盪
露丑	露醜
灵俐	伶俐
灵幡	靈旛
灵欲	靈慾
青棵	青稞
青笞	青苔
非常	非常
非常不准	非常不準
非常丑	非常醜
非常准	非常準
非常象	非常像
非涂	非涂
非涂不可	非塗不可
非象	非像
非象征服	非像征服
面丑	面醜
面价	麵價
面价值	面價值
面团	麵糰
面店	麵店
面店铺	麵店舖
面厂	麵廠
面摊	麵攤
面摊牌	面攤牌
面摊开	面攤開
面杖	麵杖
面汤	麵湯
面灰	麵灰
面疙	面疙
面疙瘩	麵疙瘩
面白	面白
面白无须	面白無鬚
面碗	麵碗
面筋	麵筋
面粉	麵粉
面糊	麵糊
面线	麵線
面茶	麵茶
面食	麵食
面食面	麵食麵
面饺	麵餃
面饼	麵餅
面馆	麵館
面馍	麵饃
面龟	麵龜
腼典	靦腆
鞣制	鞣製
鞑伐	撻伐
韦席	韋蓆
韦后	韋后
韩制	韓製
音不	音不
音不准	音不準
音准	音準
音象	音像
响当	響噹
响当当	響噹噹
页签	頁籤
页面	頁面
顶凶	頂兇
顶顶	頂頂
顶顶大名	鼎鼎大名
项炼	項鍊
顺发	順發
顺发凝露	順髮凝露
顺发水	順髮水
顺发液	順髮液
顺发素	順髮素
顺发雾	順髮霧
顺发露	順髮露
顺顺	順順
顺顺当当	順順當當
须叟	須臾
须子	鬚子
须根	鬚根
须毛	鬚毛
须求	需求
须发	鬚髮
须发展	須發展
须发文	須發文
须发表	須發表
须眉	鬚眉
须采	須採
须须	鬚鬚
须髯	鬚髯
须鬓	鬚鬢
须鲸	鬚鯨
颂赞	頌讚
预制	預製
预布	預佈
颇准	頗準
颇象	頗像
领袖	領袖
领袖欲	領袖慾
颌须	頜鬚
头亮	頭亮
头亮发	頭亮髮
头扎	頭紮
头散	頭散
头散发	頭散髮
头发	頭髮
头发了狂	頭發了狂
头发了疯	頭發了瘋
头发光	頭發光
头发出	頭發出
头发力	頭發力
头发功	頭發功
头发呆	頭發呆
头发售	頭發售
头发炎	頭發炎
头发狂	頭發狂
头发现	頭發現
头发生	頭發生
头发疯	頭發瘋
头发育	頭發育
头发麻	頭發麻
头发黑	頭發黑
头发霉	頭發霉
头花	頭花
头花发	頭花髮
颊须	頰鬚
颈系	頸繫
颓圯	頹圮
题签	題籤
愿干	願幹
愿干一杯	願乾一杯
愿乾坤	願乾坤
愿干旱	願乾旱
愿干杯	願乾杯
愿干涸	願乾涸
愿干净	願乾淨
愿干燥	願乾燥
愿干粮	願乾糧
愿干脆	願乾脆
愿干这杯	願乾這杯
愿干那杯	願乾那杯
愿意	願意
愿意干	願意幹
愿意乾坤	願意乾坤
颠仆	顛仆
颠复	顛覆
颠颠	顛顛
颠颠仆仆	顛顛仆仆
顾恤	顧卹
颤斗	顫抖
颤栗	顫慄
显象	顯像
风刮	風颳
风卷	風捲
风卷残云	風捲殘雲
风土	風土
风土志	風土誌
风姿	風姿
风姿卓约	風姿綽約
风干	風乾
风物	風物
风物志	風物誌
风范	風範
飘游	飄遊
飙卷	飆捲
飞升	飛昇
飞卷	飛捲
食欲	食慾
食面	食麵
饥年	饑年
饥荒	饑荒
饥馑	饑饉
饨面	飩麵
饭团	飯糰
饮一	飲一
饮一坛	飲一罈
饮三	飲三
饮三坛	飲三罈
饮两	飲兩
饮两坛	飲兩罈
饮干	飲乾
饮白	飲白
饮白干	飲白乾
饮而	飲而
饮而干	飲而乾
饼干	餅乾
养发	養髮
餐台	餐檯
馄饨	餛飩
馄饨面	餛飩麵
馈赠	餽贈
首只	首隻
首周	首週
首发	首發
香港	香港
香港游	香港遊
香烟	香菸
马僵	馬韁
马夫	馬伕
马夫人	馬夫人
马斯	馬斯
马斯特里	馬斯特里
马表	馬錶
马里	馬里
马里兰	馬里蘭
驻扎	駐紮
骋凶	騁兇
腾格	騰格
腾格里	騰格里
骚首	騷首
骚首弄姿	搔首弄姿
惊栗	驚慄
惊螫	驚蟄
惊赞	驚讚
骤松	驟鬆
骨坛	骨罈
骨干	骨幹
骨松	骨鬆
骨灰	骨灰
骨灰坛	骨灰罈
骼膊	胳膊
脏器	臟器
脏腑	臟腑
体征	體徵
体范	體範
高升	高昇
高干	高幹
高干脆	高乾脆
髭须	髭鬚
髯发	髯髮
髯胡	髯鬍
髯须	髯鬚
鬈发	鬈髮
鬓发	鬢髮
鬓须	鬢鬚
鬼谷	鬼谷
鬼谷子	鬼谷子
魁悟	魁梧
魂游	魂遊
魏征	魏徵
鱼干	魚乾
鱼干扰	魚干擾
鱼松	魚鬆
鲜于	鮮于
鲸须	鯨鬚
凤占	鳳占
凤凰	鳳凰
凤凰于飞	鳳凰于飛
凤斗	鳳鬥
凤皇	鳳皇
凤皇于蜚	鳳皇于蜚
鸿准	鴻準
鸿范	鴻範
鹅准	鵝準
鹤发	鶴髮
鸬慈	鸕鶿
卤制	滷製
卤味	滷味
卤水	滷水
卤汁	滷汁
卤牛	鹵牛
卤牛肉	滷牛肉
卤肉	滷肉
卤菜	滷菜
卤蛋	滷蛋
卤酱	滷醬
卤鸡	滷雞
卤面	滷麵
卤鹅	滷鵝
盐余	鹽餘
盐卤	鹽滷
麦面	麥麵
麻病	痲病
麻疯	痲瘋
么丑	麼醜
么像	麼像
么像征	麼象徵
么儿	么兒
么准	麼准
么准的	麼準的
么女	么女
么妹	么妹
么子	么子
么干	麼幹
么弟	么弟
么象	麼像
黄历	黃曆
黄发	黃髮
黄发垂髫	黃髮垂髫
黄金	黃金
黄金周	黃金週
黑亮	黑亮
黑亮发	黑亮髮
黑发	黑髮
黑发暗	黑發暗
黑须	黑鬚
点干	點幹
点干吧	點幹吧
点松	點鬆
点象	點像
霉味	霉味
霉天	霉天
霉气	霉氣
霉湿	霉濕
霉烂	霉爛
霉运	霉運
霉雨	霉雨
霉头	霉頭
鼎边	鼎邊
鼎边锉	鼎邊銼
鼻准	鼻準
鼻梁	鼻樑
齐冲	齊衝
啮齿	囓齒
龙卷	龍卷
龙卷风	龍捲風
龙眼	龍眼
龙眼干	龍眼乾
龙钟	龍鍾
龙须	龍鬚
！恩	！嗯
！象	！像
０余	０餘
０海	０海
０海里	０海里
０里	０里
披肩发	披肩髮