𪠃	𪠃
𪠌	𪠌
𪠟	𪠟
𪠡	𪠡
𪢈	𪢈
𪢋	𪢋
𪣑	𪣑
𪨞	𪨞
𪨠	𪨠
𪩔	𪩔
𪮅	𪮅
𪮴	𪮴
𪯼	𪯼
𪵇	𪵇
𪷱	𪷱
𪹹	𪹹
𪺺	𪺺
𪽱	𪽱
𫌩	𫌩
𫍏	𫍘
𫐈	𫐈
𫐷	𫐷
𫑢	𫑢
𫒅	𫒅
𫓷	𫒡
𫓻	𫓻
𫔱	𫔱
𫔳	𫔤
𫔵	𫔵
𫔷	𫔷
𫔹	𫔹
𫕳	𫕳
𫗌	𫗌
𫗲	𫗲
𫘢	𫘢
𫚖	𫚖
𫚗	𫚗
𫛿	𫛿
𫜆	𫜆
𫜫	𫜦
