㑇	㑳
㑔	㑯
㘎	㘚
㚯	㜄
㛣	㜏
㟆	㠏
㤘	㥮
㧐	㩳
㨫	㩜
䀥	䁻
䌶	䊷
䌺	䋙
䌻	䋚
䌾	䋻
䎬	䎱
䙌	䙡
䜧	䜀
䞍	䝼
䥾	䥱
䦂	䥇
䦶	䦛
䦷	䦟
䯅	䯀
䲝	䱽
䲣	䱷
刾	㓨
鲃	䰾
鳚	䲁
鹮	䴉
𠉂	㒓
𠵾	㗲
𡝠	㜷
𡞱	㜢
𢋈	㢝
𢛯	㦎
𤈷	㷿
𤠋	㺏
𤽯	㿧
𥅴	䀹
𥇢	䁪
𥬀	䉙
𥮜	䉲
𥺅	䊭
𦈓	䋿
𦈖	䌈
𦈘	䌋
𦈙	䌰
𦈜	䌖
𦈞	䌟
𦈟	䌝
𦈠	䌥
𦰴	䕳
𧉞	䗿
𧹑	䞈
𧹕	䝻
𨑹	䢨
𨱖	䥩
𨷿	䦳
𨸄	䦘
𨸟	䧢
𩏼	䪏
𩏿	䪘
𩐀	䪗
𩖗	䫴
𩙧	䬞
𩙮	䬘
𩙯	䬝
𩠇	䭀
𩠈	䭃
𩧪	䮾
𩧭	䭿
𩧰	䮝
𩧿	䮠
𩨁	䮞
𩨇	䮫
𩨏	䮳
𩾂	䲖
𩾈	䱙
𩾊	䱬
𩾋	䱰
𪉂	䲰
𪎈	䴬
𪎋	䴴
𪢌	㘓
𪦂	㜩
𪨊	㞞
𪩇	㟺
𪮃	㨻
𪮋	㩋
𪷍	㵾
𪺻	㺜
𪽮	㿖
𫀨	䅐
𫁂	䆉
𫁲	䉑
𫁷	䉶
𫂈	䉬
𫄚	䊺
𫄜	䋃
𫄞	䋔
𫄩	䋦
𫄮	䋼
𫆙	䑁
𫊪	䗅
𫋲	䙔
𫋸	䙃
𫌯	䚩
𫍚	䚶
𫍠	䛄
𫍫	䛳
𫎧	䝭
𫎪	䞋
𫎭	䞓
𫎱	䟐
𫎳	䟆
𫎺	䟃
𫏃	䠆
𫐕	䡺
𫔆	䥯
𫔋	䥗
𫖅	䪊
𫖺	䫶
𫗇	䫻
𫗊	䬓
𫗟	䬧
𫗰	䭔
𫗱	䭑
𫘮	䮰
𫚏	䱁
𫚐	䱀
𫚜	䲅
𫚠	䱧
𫛬	䳜
𫛮	䳤
𫛰	䳢
𫛺	䳧
𫛼	䳫
𫜅	䴋
𫜒	䴱
𫜔	䴽
𫜨	䶕
𫜳	䶲
