㛟	𡞵
㛠	𡢃
㛿	𡠹
㟜	𡾱
㭣	𣙎
㳢	𣾷
㻏	𤫩
㻘	𤪺
䅪	𥢢
䘛	𧝞
䘞	𧜗
䙊	𧜵
䜥	𧩙
䞌	𧵳
䞎	𧶧
䢀	𨊰
䢁	𨊸
䢂	𨋢
䥿	𨯅
䦀	𨦫
䦁	𨧜
䭪	𩞯
䯃	𩣑
䲞	𩶘
𠆿	𠌥
𠉗	𠏢
𠚳	𠠎
𠛆	𠞆
𠲥	𡅏
𠴢	𡄔
𠵸	𡄣
𡋀	𡓾
𡋗	𡑭
𡭜	𡮉
𡭬	𡮣
𢘝	𢣚
𢘞	𢣭
𢫊	𢷮
𢫞	𢶫
𢬦	𢹿
𣍨	𦢈
𣑶	𣠲
𣘓	𣞻
𣘷	𣝕
𣭤	𣯴
𣶫	𣿉
𣺽	𤁣
𤊀	𤒎
𤳄	𤳸
𤶧	𤸫
𥅘	𥌃
𥐯	𥖅
𥐰	𥕥
𥧂	𥨐
𥭉	𥵊
𥮋	𥸠
𥱔	𥵃
𥹥	𥼽
𥺇	𥽖
𦈈	𥿊
𦈒	𦂅
𦈗	𦃄
𦟗	𦣎
𦨩	𦪽
𧒭	𧔥
𧳕	𧳟
𧹓	𧶔
𧿈	𨇁
𨀱	𨄣
𨁴	𨅍
𨂺	𨈊
𨄄	𨈌
𨅫	𨇞
𨐆	𨊻
𨐇	𨏠
𨐉	𨎮
𨐊	𨏥
𨤰	𨤻
𨱀	𨥛
𨱊	𨧱
𨱐	𨫒
𨱕	𨮂
𨸀	𨳕
𨸁	𨳑
𨸅	𨴗
𨸆	𨵩
𨸇	𨵸
𨸉	𨶀
𨸊	𨶏
𨸋	𨶲
𨸌	𨶮
𨸎	𨷲
𨸘	𨽏
𩏽	𩏪
𩏾	𩎢
𩖕	𩓣
𩙦	𩗀
𩙨	𩘹
𩙩	𩘀
𩙬	𩘺
𩙭	𩘝
𩙰	𩙈
𩟿	𩚛
𩠀	𩚥
𩠁	𩚵
𩠂	𩛆
𩠃	𩛩
𩠅	𩟐
𩠆	𩜦
𩠉	𩜇
𩠊	𩜵
𩠋	𩝔
𩠎	𩞄
𩠏	𩞦
𩠠	𩠴
𩧦	𩡺
𩧩	𩤊
𩧬	𩢡
𩧮	𩢾
𩧱	𩥉
𩧳	𩢸
𩧵	𩢴
𩧶	𩣏
𩧼	𩣺
𩨅	𩤸
𩨆	𩤙
𩨉	𩤲
𩨋	𩥄
𩨌	𩥑
𩨍	𩥇
𩨐	𩧆
𩬣	𩭙
𩬤	𩰀
𩯒	𩯳
𩲒	𩳤
𩽺	𩵩
𩽻	𩵹
𩽽	𩶱
𩽿	𩶰
𩾄	𩷰
𩾅	𩸃
𩾆	𩸦
𩾎	𩽇
𪉄	𩿪
𪉅	𪀦
𪉉	𪁈
𪉋	𪀾
𪉌	𪁖
𪉎	𪂆
𪉏	𪃏
𪉐	𪃍
𪉒	𪄕
𪉔	𪄆
𪉕	𪇳
𪎍	𪋿
𪔭	𪔵
𪚏	𪘀
𪚐	𪘯
𪜎	𠿕
𪝘	𠏍
𪠀	𧷎
𪠺	𠽃
𪢐	𡃤
𪢒	𡂡
𪢖	𡅯
𪥠	𧹈
𪨇	𠒺
𪨩	𡸗
𪨹	𡹬
𪩛	𡿖
𪬯	𢤿
𪭮	𢶢
𪭯	𢶒
𪭱	𢭯
𪮳	𢺳
𪶒	𤄷
𪶮	𣽏
𪹀	𤑹
𪹠	𤓌
𪺸	𤠮
𪼴	𤬅
𪽂	𪌜
𪽝	𤳷
𪽭	𤷃
𪽴	𤺔
𪿊	𥏝
𪿞	𥖲
𫀌	𥜰
𫀓	𥜐
𫀮	𥢷
𫁳	𥯤
𫁺	𥴼
𫂖	𥴨
𫄝	𥾯
𫄦	𦀖
𫄪	𦅇
𫄯	𦃩
𫄵	𦅈
𫆝	𦟼
𫉚	𧅰
𫊨	𧎵
𫊹	𧒯
𫌋	𧞫
𫌫	𧡴
𫌬	𧢄
𫍞	𧦝
𫍟	𧦧
𫍭	𧩕
𫍶	𧩼
𫍺	𧫝
𫍼	𧬤
𫍽	𧭴
𫍾	𧭈
𫎨	𧸘
𫎲	𧽤
𫎸	𧽯
𫏌	𨂐
𫏑	𨇽
𫏕	𨆪
𫏞	𨇰
𫏠	𨈇
𫏨	𨇤
𫐋	𨎌
𫐍	𨌈
𫐔	𨍰
𫓫	𨥟
𫓮	𨪕
𫓳	𨰋
𫓼	𨨛
𫓿	𨨢
𫔃	𨰲
𫔉	𨰃
𫔏	𨬖
𫔐	𨭸
𫔑	𨭖
𫔒	𨮳
𫔓	𨯟
𫔕	𨰥
𫔲	𨴹
𫔸	𨷶
𫕚	𩀨
𫖑	𩎖
𫖓	𩏂
𫖖	𩏠
𫗈	𩗓
𫗉	𩗴
𫗡	𩚩
𫗤	𩛌
𫗨	𩛡
𫗳	𩝽
𫚎	𩶁
𫚘	𩻮
𫚝	𩸄
𫚟	𩸡
𫚨	𩻗
𫚩	𩻬
𫚬	𩼶
𫛠	𩿤
𫛧	𪀖
𫛹	𪃧
𫛻	𪃒
𫛾	𪆷
𫜂	𪅂
𫜊	𪉸
𫜓	𪌭
𫜕	𪍠
𫜟	𪓰
𫜯	𪙏
