万	万
丰	丰
乃	迺
仇	讎
俊	儁
党	党
凌	淩
厂	厂
厘	厘
参	蔘
叶	叶
唇	脣
噪	譟
娘	孃
宁	甯
帘	帘
广	广
录	彔
恤	卹
极	极
柜	柜
橹	艣 艪
皂	皁
眯	眯
矩	榘
确	确
私	俬
秋	鞦
种	种
罗	儸
胁	脇
胜	胜
胡	衚
腊	腊
腌	腌
芸	蕓
苏	囌
荐	荐
药	葯
莼	蒓
虫	虫
蚝	蚝
蜡	蜡
谥	謚
适	适
采	埰 寀
针	鍼
镋	鎲
闲	閑
𫄠	絚 絙
