㘓	𪢌
㜩	𪦂
㞞	𪨊
㟺	𪩇
㨻	𪮃
㩋	𪮋
㵾	𪷍
㺜	𪺻
㿖	𪽮
䅐	𫀨
䆉	𫁂
䉑	𫁲
䉬	𫂈
䉶	𫁷
䊺	𫄚
䋃	𫄜
䋔	𫄞
䋦	𫄩
䋼	𫄮
䑁	𫆙
䗅	𫊪
䙃	𫋸
䙔	𫋲
䚩	𫌯
䚶	𫍚
䛄	𫍠
䛳	𫍫
䝭	𫎧
䞋	𫎪
䞓	𫎭
䟃	𫎺
䟆	𫎳
䟐	𫎱
䠆	𫏃
䡺	𫐕
䥗	𫔋
䥯	𫔆
䪊	𫖅
䫶	𫖺
䫻	𫗇
䬓	𫗊
䬧	𫗟
䭑	𫗱
䭔	𫗰
䮰	𫘮
䱀	𫚐
䱁	𫚏
䱧	𫚠
䲅	𫚜
䳜	𫛬
䳢	𫛰
䳤	𫛮
䳧	𫛺
䳫	𫛼
䴋	𫜅
䴱	𫜒
䴽	𫜔
䶕	𫜨
䶲	𫜳
凙	𪞝
勣	𪟝
嗹	𪡏
嘪	𪡃
嘳	𪡞
嘺	𪡀
噞	𪡋
噹	𪠽
嚛	𪠸
嚽	𪢕
囒	𪢠
圞	𪢮
堚	𪣒
塿	𪣻
壣	𪤚
嬣	𪥰
嬻	𪥿
孾	𪧀
屩	𪨗
崙	𪨧
巊	𪩎
巗	𪨷
掚	𪭵
撊	𪭾
撧	𪮖
擟	𪭧
攋	𪮶
曊	𪰶
朥	𫆟
梖	𪱷
檷	𪱾
櫅	𪲎
櫠	𪲮
欐	𪲔
欑	𪴙
歞	𪴯
溡	𪶄
澳	𪶓
濧	𪶊
濿	𪵱
灆	𪷞
灒	𪷽
煇	𪸩
熂	𪸕
爥	𪹳
獊	𪺷
瑻	𪻲
瑽	𪻐
璝	𪻺
畼	𪽈
痮	𪽪
瘱	𪽷
盨	𪾔
眝	𪾣
睍	𪾢
矑	𪾦
礜	𪿝
竱	𫁟
糺	𫄙
紟	𫄛
絁	𫄟
絙	𫄠
絥	𫄢
絧	𫄡
絺	𫄨
綖	𫄧
綟	𫄫
緤	𫄬
緮	𫄭
縍	𫄰
縰	𫄳
縸	𫄲
繂	𫄴
繈	𫄶
繨	𫄤
繬	𫄱
繶	𫄷
繷	𫄣
纁	𫄸
纗	𫄹
纚	𫄥
膹	𪱥
葝	𫈎
蒍	𫇭
蒭	𫇴
蔯	𫈟
蕝	𫈵
蕳	𫈉
蕽	𫇽
薆	𫉁
藷	𫉄
蟂	𫋇
蟘	𫋌
蟜	𫊸
蟳	𫊻
蠦	𫊮
襀	𫌀
襂	𫌄
襓	𫋹
襗	𫋷
襘	𫋻
襵	𫌇
覛	𫌪
覹	𫌭
覼	𫌨
訑	𫍙
訜	𫍛
詑	𫍡
詓	𫍜
詷	𫍣
誂	𫍥
誋	𫍪
誫	𫍨
誳	𫍮
誷	𫍬
誺	𫍧
諣	𫍩
諥	𫍳
諫	𫍝
諯	𫍱
諰	𫍰
諴	𫍯
謆	𫍸
謉	𫍷
謏	𫍲
謯	𫍹
謱	𫍴
謸	𫍵
譆	𫍻
譊	𫍢
譑	𫍤
譨	𫍦
豵	𫎆
貗	𫎌
賝	𫎩
贉	𫎫
贑	𫎬
贚	𫎦
蹔	𫏐
蹳	𫏆
蹻	𫏋
軏	𫐄
軕	𫐅
軜	𫐇
軨	𫐉
軬	𫐊
軿	𫐌
輋	𪨶
輖	𫐏
輗	𫐐
輢	𫐎
輨	𫐑
輮	𫐓
輷	𫐒
轇	𫐖
轊	𫐕
轐	𫐗
轗	𫐘
轠	𫐙
轣	𫐆
鄟	𫑘
鄳	𫑡
鄽	𫑮
醶	𫑷
釟	𫓥
釨	𫓦
鈆	𫓪
鈇	𫓧
鈛	𫓨
鉔	𫓬
鉠	𫓭
鉾	𫓴
銁	𫓲
銈	𫓯
銊	𫓰
鋄	𫓸
鋗	𫓶
鋠	𫓵
錝	𫓽
錤	𫓹
錥	𫓾
鍉	𫔂
鍊	𫔀
鍒	𫔄
鎍	𫔅
鎙	𫔈
鎞	𫔇
鏥	𫔊
鏦	𫓩
鏾	𫔌
鐇	𫔍
鐈	𫓱
鐍	𫔎
鐪	𫓺
鐼	𫔁
鑴	𫔔
開	𫔭
閒	𫔮
閞	𫔰
閵	𫔴
闑	𫔶
陘	𫔽
隮	𫕅
霣	𫕥
霼	𪵣
靧	𫖃
鞾	𫖇
韛	𫖔
韝	𫖕
韡	𫖒
願	𫖸
顣	𫖹
飋	𫗋
飦	𫗞
飵	𫗢
飶	𫗣
餔	𫗦
餗	𫗧
餦	𫗠
餧	𫗪
餪	𫗬
餫	𫗥
餬	𫗫
餭	𫗮
餱	𫗯
餵	𫗭
饘	𫗴
饟	𫗵
饠	𫗩
馯	𫘛
馼	𫘜
駃	𫘝
駊	𫘟
駞	𫘞
駤	𫘠
駫	𫘡
駻	𫘣
騃	𫘤
騄	𫘧
騉	𫘥
騊	𫘦
騜	𫘩
騠	𫘨
騱	𫘬
騴	𫘫
騵	𫘪
騻	𫘭
驓	𫘯
驙	𫘰
驨	𫘱
鬦	𫔯
魟	𫚉
魦	𫚌
魵	𫚍
鮄	𫚒
鮅	𫚑
鮤	𫚓
鮰	𫚔
鮵	𫚛
鮿	𫚚
鯆	𫚙
鯞	𫚡
鯬	𫚞
鯾	𫚣
鰋	𫚢
鰑	𫚊
鰕	𫚥
鰤	𫚕
鰦	𫚤
鰫	𫚦
鰽	𫚧
鱄	𫚋
鱊	𫚪
鱢	𫚫
鱮	𫚈
鳷	𫛛
鳽	𫛚
鴀	𫛜
鴃	𫛞
鴅	𫛝
鴐	𫛤
鴔	𫛡
鴗	𫁡
鴥	𫛣
鴮	𫛦
鴳	𫛩
鴽	𫛪
鵊	𫛥
鵟	𫛭
鵧	𫛨
鵩	𫛳
鵫	𫛱
鵰	𫛲
鶌	𫛵
鶒	𫛶
鶗	𫛸
鶦	𫛷
鶭	𫛯
鶰	𫛫
鷅	𫛽
鷐	𫜀
鷣	𫜃
鷤	𫛴
鷩	𫜁
鷷	𫜄
鸋	𫛢
鸗	𫛟
麷	𫜑
齧	𫜩
齩	𫜪
齭	𫜭
齰	𫜬
齴	𫜮
齾	𫜰
龓	𫜲
𠏍	𪝘
𠒺	𪨇
𠽃	𪠺
𠿕	𪜎
𡂡	𪢒
𡃤	𪢐
𡅯	𪢖
𡸗	𪨩
𡹬	𪨹
𡿖	𪩛
𢤿	𪬯
𢭯	𪭱
𢶒	𪭯
𢶢	𪭮
𢺳	𪮳
𣽏	𪶮
𤄷	𪶒
𤑹	𪹀
𤓌	𪹠
𤠮	𪺸
𤬅	𪼴
𤳷	𪽝
𤷃	𪽭
𤺔	𪽴
𥏝	𪿊
𥖲	𪿞
𥜐	𫀓
𥜰	𫀌
𥢷	𫀮
𥯤	𫁳
𥴨	𫂖
𥴼	𫁺
𥾯	𫄝
𦀖	𫄦
𦃩	𫄯
𦅇	𫄪
𦅈	𫄵
𦟼	𫆝
𧅰	𫉚
𧎵	𫊨
𧒯	𫊹
𧞫	𫌋
𧡴	𫌫
𧢄	𫌬
𧦝	𫍞
𧦧	𫍟
𧩕	𫍭
𧩼	𫍶
𧫝	𫍺
𧬤	𫍼
𧭈	𫍾
𧭴	𫍽
𧷎	𪠀
𧸘	𫎨
𧹈	𪥠
𧽤	𫎲
𧽯	𫎸
𨂐	𫏌
𨆪	𫏕
𨇤	𫏨
𨇰	𫏞
𨇽	𫏑
𨈇	𫏠
𨌈	𫐍
𨍰	𫐔
𨎌	𫐋
𨥟	𫓫
𨨛	𫓼
𨨢	𫓿
𨪕	𫓮
𨬖	𫔏
𨭖	𫔑
𨭸	𫔐
𨮳	𫔒
𨯟	𫔓
𨰃	𫔉
𨰋	𫓳
𨰥	𫔕
𨰲	𫔃
𨷶	𫔸
𩀨	𫕚
𩎖	𫖑
𩏂	𫖓
𩏠	𫖖
𩗓	𫗈
𩗴	𫗉
𩚩	𫗡
𩛌	𫗤
𩛡	𫗨
𩝽	𫗳
𩶁	𫚎
𩸄	𫚝
𩸡	𫚟
𩻗	𫚨
𩻬	𫚩
𩻮	𫚘
𩼶	𫚬
𩿤	𫛠
𪀖	𫛧
𪃒	𫛻
𪃧	𫛹
𪅂	𫜂
𪆷	𫛾
𪉸	𫜊
𪌜	𪽂
𪌭	𫜓
𪍠	𫜕
𪓰	𫜟
𪙏	𫜯
𫍘	𫍏
𫒡	𫓷
𫚖	𫚖
𫚗	𫚗
𫜦	𫜫
