‘	『
’	』
“	「
”	」
僞	偽
兇	凶
啓	啟
嫺	嫻
嬀	媯
峯	峰
幺	么
擡	抬
棱	稜
污	汙
泄	洩
涌	湧
潙	溈
潨	潀
爲	為
牀	床
皁	皂
痹	痺
癡	痴
着	著
睾	睪
竈	灶
糉	粽
繮	韁
粘	黏
纔	才
羣	群
蔿	蒍
脣	唇
蔘	參
衆	眾
衞	衛
裏	裡
覈	核
踊	踴
鉢	缽
鮎	鯰
鈎	鉤
鍼	針
鷄	雞
麪	麵
齶	顎
