㑳	㑇
㘚	㘎
㠏	㟆
㥮	㤘
㩜	㨫
㩳	㧐
䊷	䌶
䋙	䌺
䋻	䌾
䎱	䎬
䙡	䙌
䝼	䞍
䥇	䦂
䦛	䦶
䦟	䦷
䯀	䯅
䱷	䲣
䱽	䲝
儸	㑩
劏	㓥
劚	㔉
喎	㖞
噚	㖊
掆	㧏
撝	㧑
擓	㧟
棡	㭎
殨	㱮
殰	㱩
澾	㳠
瀇	㲿
煱	㶽
燶	㶶
獱	㺍
瞜	䁖
稏	䅉
穇	䅟
筴	䇲
紬	䌷
絅	䌹
綐	䌼
綵	䌽
縳	䌸
繸	䍁
繿	䍀
膞	䏝
薳	䓕
藭	䓖
螮	䗖
襬	䙓
訢	䜣
譅	䜧
讌	䜩
貙	䝙
賰	䞐
釾	䥺
鏺	䥽
鐥	䦅
鐯	䦃
钁	䦆
騧	䯄
鮣	䲟
鰆	䲠
鰌	䲡
鰧	䲢
鳾	䴓
鴷	䴕
鵁	䴔
鶄	䴖
鶪	䴗
鷈	䴘
鷉	䴘
鷿	䴙
鸂	㶉
鸊	䴙
龑	䶮
𡞵	㛟
𡠹	㛿
𡢃	㛠
𤪺	㻘
𤫩	㻏
𦪙	䑽
𧜵	䙊
𧝞	䘛
𧩙	䜥
𧵳	䞌
𨋢	䢂
𨦫	䦀
𨧜	䦁
𨯅	䥿
𩞯	䭪
𩣑	䯃
𩶘	䲞
