䌈	𦈖
䪏	𩏼
䪗	𩐀
䪘	𩏿
䫴	𩖗
䬘	𩙮
䬝	𩙯
䭀	𩠇
䭃	𩠈
䭿	𩧭
䮝	𩧰
䮞	𩨁
䮠	𩧿
䮳	𩨏
䮾	𩧪
䱙	𩾈
䱬	𩾊
䱰	𩾋
䲰	𪉂
䴬	𪎈
䴴	𪎋
嗰	𠮶
壈	𡒄
釳	𨰿
鈋	𨱂
鈠	𨱁
鈯	𨱄
鈲	𨱃
鉁	𨱅
銶	𨱇
鋉	𨱈
錂	𨱋
鍄	𨱉
鍮	𨱎
鎝	𨱏
鎯	𨱍
鎷	𨰾
鏆	𨱌
鏉	𨱒
鐎	𨱓
鐏	𨱔
閍	𨸂
閐	𨸃
顃	𩖖
颰	𩙥
颷	𩙪
颾	𩙫
餸	𩠌
駎	𩧨
駚	𩧫
駧	𩧲
駩	𩧴
駶	𩧺
騔	𩨀
騚	𩨊
騝	𩨃
騟	𩨈
騪	𩨄
驋	𩧯
魥	𩽹
鮕	𩾀
鮟	𩽾
鮸	𩾃
鯄	𩾁
鯱	𩾇
鯶	𩽼
鱇	𩾌
鳼	𪉃
鴜	𪉈
鴲	𪉆
鵚	𪉍
鷔	𪉑
鷨	𪉊
麨	𪎊
麲	𪎉
麳	𪎌
𨥛	𨱀
𨧱	𨱊
𨫒	𨱐
𨮂	𨱕
𩎢	𩏾
𩏪	𩏽
𩓣	𩖕
𩗀	𩙦
𩗡	𩙧
𩘀	𩙩
𩘝	𩙭
𩘹	𩙨
𩘺	𩙬
𩙈	𩙰
𩜦	𩠆
𩝔	𩠋
𩟐	𩠅
𩡺	𩧦
𩢡	𩧬
𩢴	𩧵
𩢸	𩧳
𩢾	𩧮
𩣏	𩧶
𩣵	𩧻
𩣺	𩧼
𩤊	𩧩
𩤙	𩨆
𩤲	𩨉
𩤸	𩨅
𩥄	𩨋
𩥇	𩨍
𩥉	𩧱
𩥑	𩨌
𩧆	𩨐
𩵩	𩽺
𩵹	𩽻
𩶰	𩽿
𩶱	𩽽
𩷰	𩾄
𩸃	𩾅
𩸦	𩾆
𩽇	𩾎
𩿪	𪉄
𪀦	𪉅
𪀾	𪉋
𪁈	𪉉
𪁖	𪉌
𪂆	𪉎
𪃍	𪉐
𪃏	𪉏
𪄆	𪉔
𪄕	𪉒
𪇳	𪉕
𪘀	𪚏
𪘯	𪚐
