%n个	%n個
%n克	%n克
%n冲	%n沖
%n出剧	%n齣劇
%n出戏	%n齣戲
%n划	%n劃
%n发	%n發
%n只	%n隻
%n台	%n臺
%n周	%n週 %n周
%n周年	%n週年
%n回	%n回
%n天后	%n天後
%n扎	%n紥
%n折	%n折
%n斗	%n斗
%n杯	%n杯
%n海里	%n海里
%n里	%n里
%n面	%n面
