中	中
丹麥	丹麥
以色列	以色列
俄	俄
冰島	冰島
匈牙利	匈牙利
印尼	印尼
印度	印度
埃及	埃及
希臘	希臘
德	德
挪威	挪威
日	日
朝鮮	朝鮮
法	法
泰	泰
漢	漢
烏克蘭	烏克蘭
瑞典	瑞典
瑞士	瑞士
緬甸	緬甸
義大利	義大利
芬蘭	芬蘭
英	英
荷蘭	荷蘭
華	華
葡萄牙	葡萄牙
西班牙	西班牙
越南	越南
阿拉伯	阿拉伯
韓	韓
馬來	馬來
馬來西亞	馬來西亞
