今周刊	今周刊
低質量	低品質
作業程序	作業程序
保持水平	保持水平
兆字節	百萬位元組
內存在	內存在 記憶體在
內存夠	內存夠 記憶體夠
內存有	內存有 記憶體有
內存着	內存著
司法程序	司法程序
回放	重播
奔馳的	奔馳的 賓士的
工作程序	工作程序
幹嗎	幹嘛 幹嗎
弄黑	弄黑
後媽	繼母
後爹	繼父
投影片	投影片
提高	提高
有回放學	有回放學
橙子	柳丁
水平	水準 水平
水平面	水平面
法律程序	法律程序
滿意的質量	滿意的品質
的士兵	的士兵
秋衣	衛生衣
秋褲	衛生褲
空氣質量	空氣品質
竈門	竈門
納米比亞	納米比亞
蒼崎橙子	蒼崎橙子
行政程序	行政程序
質量	質量 品質
質量令人滿意	品質令人滿意
質量夠好	品質夠好
質量夠差	品質夠差
質量夠硬	品質夠好
質量好	品質好
質量差	品質差
錄像出租	影片出租
音視頻流	影音串流
音頻流	音訊串流
音頻流媒	音訊串流媒體
音頻流媒體	音訊串流媒體
高端疫苗	高端疫苗
高質量	高品質
