卓著	卓著
原著	原著
專著	專著
所著	所著
拙著	拙著
持續著	持續着
持續著作	持續著作
持續著作品	持續着作品
撰著	撰著 撰着
文著	文著
新著	新著
日新月著	日新月著
知著	知著
編著	編著 編着
而著	而著
自著	自著
著:	著:
著〈	著〈
著《	著《
著成	著成
著撰	著撰
著文	著文
著於	著於
著明	著明
著有	著有
著論	著論
著譯	著譯
著足	著足
著：	著：
論著	論著
譯著	譯著 譯着
較著	較著
遺著	遺著
醫著	醫著 醫着
雜著	雜著
頗著	頗著
